start,end,dt,monthly_ocupancy,daily_ocupancy,hourly_ocupancy,monthly_vacant,daily_vacant,hourly_vacant,hourly_freq,daily_freq,holiday_score,date_only
2020-01-03 08:35:00,2020-01-04 08:35:00,24.0,260,2,1,255,4,1,0,-2,0,2020-01-03
2020-01-04 08:25:00,2020-01-05 08:25:00,24.0,260,7,4,255,8,2,2,-1,0,2020-01-04
2020-01-04 09:30:00,2020-01-05 09:30:00,24.0,260,7,2,255,8,2,0,-1,0,2020-01-04
2020-01-05 14:30:00,2020-01-05 16:30:00,2.0,260,15,2,255,8,1,1,7,0,2020-01-05
2020-01-05 21:00:00,2020-01-06 21:00:00,24.0,260,15,1,255,17,1,0,-2,0,2020-01-05
2020-01-06 01:00:00,2020-02-06 01:00:00,744.0,260,20,1,224,10,1,0,10,2,2020-01-06
2020-01-06 07:20:00,2020-01-07 07:20:00,24.0,260,20,7,255,13,4,3,7,2,2020-01-06
2020-01-06 07:30:00,2020-01-10 22:30:00,111.0,260,20,7,255,10,1,6,10,2,2020-01-06
2020-01-06 07:35:00,2020-01-07 07:35:00,24.0,260,20,7,255,13,4,3,7,2,2020-01-06
2020-01-06 08:00:00,2020-01-07 08:00:00,24.0,260,20,7,255,13,5,2,7,2,2020-01-06
2020-01-06 08:15:00,2020-01-07 08:15:00,24.0,260,20,7,255,13,5,2,7,2,2020-01-06
2020-01-06 08:35:00,2020-01-07 08:35:00,24.0,260,20,7,255,13,5,2,7,2,2020-01-06
2020-01-06 08:40:00,2020-01-07 08:40:00,24.0,260,20,7,255,13,5,2,7,2,2020-01-06
2020-01-06 09:10:00,2020-01-07 09:10:00,24.0,260,20,3,255,13,2,1,7,2,2020-01-06
2020-01-06 09:25:00,2020-01-06 13:25:00,4.0,260,20,3,255,17,1,2,3,2,2020-01-06
2020-01-06 09:25:00,2020-01-07 09:25:00,24.0,260,20,3,255,13,2,1,7,2,2020-01-06
2020-01-06 17:50:00,2020-01-09 17:50:00,72.0,260,20,1,255,13,1,0,7,2,2020-01-06
2020-01-07 07:15:00,2020-01-08 07:15:00,24.0,260,15,3,255,20,3,0,-5,0,2020-01-07
2020-01-07 07:55:00,2020-01-08 07:55:00,24.0,260,15,3,255,20,3,0,-5,0,2020-01-07
2020-01-07 08:30:00,2020-01-08 08:30:00,24.0,260,15,7,255,20,8,-1,-5,0,2020-01-07
2020-01-07 08:30:00,2020-01-08 08:30:00,24.0,260,15,7,255,20,8,-1,-5,0,2020-01-07
2020-01-07 08:45:00,2020-01-08 08:45:00,24.0,260,15,7,255,20,8,-1,-5,0,2020-01-07
2020-01-07 09:40:00,2020-01-08 09:40:00,24.0,260,15,4,255,20,3,1,-5,0,2020-01-07
2020-01-08 06:55:00,2020-01-09 06:55:00,24.0,260,17,1,255,13,1,0,4,1,2020-01-08
2020-01-08 07:25:00,2020-01-09 07:25:00,24.0,260,17,5,255,13,2,3,4,1,2020-01-08
2020-01-08 07:40:00,2020-01-11 07:40:00,72.0,260,17,5,255,3,1,4,14,1,2020-01-08
2020-01-08 08:10:00,2020-01-09 08:10:00,24.0,260,17,4,255,13,4,0,4,1,2020-01-08
2020-01-08 08:30:00,2020-01-09 08:30:00,24.0,260,17,4,255,13,4,0,4,1,2020-01-08
2020-01-08 08:35:00,2020-01-09 08:35:00,24.0,260,17,4,255,13,4,0,4,1,2020-01-08
2020-01-08 09:35:00,2020-01-09 09:35:00,24.0,260,17,2,255,13,1,1,4,1,2020-01-08
2020-01-08 12:35:00,2020-01-08 17:35:00,5.0,260,17,2,255,20,1,1,-3,1,2020-01-08
2020-01-08 13:15:00,2020-01-08 14:15:00,1.0,260,17,1,255,20,1,0,-3,1,2020-01-08
2020-01-09 07:15:00,2020-01-10 07:15:00,24.0,260,10,1,255,10,1,0,0,0,2020-01-09
2020-01-09 08:20:00,2020-01-10 08:20:00,24.0,260,10,3,255,10,3,0,0,0,2020-01-09
2020-01-09 08:30:00,2020-01-10 08:30:00,24.0,260,10,3,255,10,3,0,0,0,2020-01-09
2020-01-09 09:30:00,2020-01-10 09:30:00,24.0,260,10,1,255,10,1,0,0,0,2020-01-09
2020-01-09 17:55:00,2020-01-10 17:55:00,24.0,260,10,1,255,10,1,0,0,0,2020-01-09
2020-01-10 09:30:00,2020-01-10 20:30:00,11.0,260,2,2,255,10,1,1,-8,0,2020-01-10
2020-01-11 08:45:00,2020-01-12 08:45:00,24.0,260,8,4,255,11,3,1,-3,5,2020-01-11
2020-01-13 01:00:00,2020-02-13 01:00:00,744.0,260,12,1,224,12,1,0,0,0,2020-01-13
2020-01-13 08:00:00,2020-01-14 08:00:00,24.0,260,12,5,255,10,5,0,2,0,2020-01-13
2020-01-13 08:10:00,2020-01-14 08:10:00,24.0,260,12,5,255,10,5,0,2,0,2020-01-13
2020-01-13 08:15:00,2020-01-14 08:15:00,24.0,260,12,5,255,10,5,0,2,0,2020-01-13
2020-01-13 09:50:00,2020-01-14 09:50:00,24.0,260,12,2,255,10,1,1,2,0,2020-01-13
2020-01-14 08:05:00,2020-01-17 08:05:00,72.0,260,13,6,255,7,4,2,6,0,2020-01-14
2020-01-14 08:25:00,2020-01-15 08:25:00,24.0,260,13,6,255,14,5,1,-1,0,2020-01-14
2020-01-14 09:05:00,2020-01-15 09:05:00,24.0,260,13,4,255,14,4,0,-1,0,2020-01-14
2020-01-14 15:40:00,2020-01-15 15:40:00,24.0,260,13,1,255,14,1,0,-1,0,2020-01-14
2020-01-15 07:45:00,2020-01-16 07:45:00,24.0,260,15,3,255,11,2,1,4,0,2020-01-15
2020-01-15 07:50:00,2020-01-16 07:50:00,24.0,260,15,3,255,11,2,1,4,0,2020-01-15
2020-01-15 08:00:00,2020-01-16 08:00:00,24.0,260,15,9,255,11,9,0,4,0,2020-01-15
2020-01-15 08:10:00,2020-01-16 08:10:00,24.0,260,15,9,255,11,9,0,4,0,2020-01-15
2020-01-15 08:25:00,2020-01-16 08:25:00,24.0,260,15,9,255,11,9,0,4,0,2020-01-15
2020-01-15 08:45:00,2020-01-16 08:45:00,24.0,260,15,9,255,11,9,0,4,0,2020-01-15
2020-01-15 09:10:00,2020-01-18 09:10:00,72.0,260,15,2,255,6,2,0,9,0,2020-01-15
2020-01-16 08:15:00,2020-01-17 08:15:00,24.0,260,5,3,255,7,4,-1,-2,0,2020-01-16
2020-01-16 08:30:00,2020-01-17 08:30:00,24.0,260,5,3,255,7,4,-1,-2,0,2020-01-16
2020-01-16 17:45:00,2020-01-17 17:45:00,24.0,260,5,1,255,7,1,0,-2,0,2020-01-16
2020-01-17 07:10:00,2020-01-18 07:10:00,24.0,260,5,2,255,6,2,0,-1,0,2020-01-17
2020-01-17 07:50:00,2020-01-18 07:50:00,24.0,260,5,2,255,6,2,0,-1,0,2020-01-17
2020-01-17 08:25:00,2020-01-18 08:25:00,24.0,260,5,2,255,6,2,0,-1,0,2020-01-17
2020-01-17 08:30:00,2020-01-18 08:30:00,24.0,260,5,2,255,6,2,0,-1,0,2020-01-17
2020-01-17 09:15:00,2020-01-18 09:15:00,24.0,260,5,1,255,6,2,-1,-1,0,2020-01-17
2020-01-20 08:05:00,2020-01-21 08:05:00,24.0,260,8,5,255,8,5,0,0,0,2020-01-20
2020-01-20 08:20:00,2020-01-21 08:20:00,24.0,260,8,5,255,8,5,0,0,0,2020-01-20
2020-01-20 08:30:00,2020-01-21 08:30:00,24.0,260,8,5,255,8,5,0,0,0,2020-01-20
2020-01-20 09:30:00,2020-01-26 19:30:00,154.0,260,8,2,255,3,1,1,5,0,2020-01-20
2020-01-20 13:35:00,2020-01-21 13:35:00,24.0,260,8,1,255,8,1,0,0,0,2020-01-20
2020-01-21 08:05:00,2020-01-22 08:05:00,24.0,260,11,5,255,10,5,0,1,0,2020-01-21
2020-01-21 08:30:00,2020-01-22 08:30:00,24.0,260,11,5,255,10,5,0,1,0,2020-01-21
2020-01-21 10:00:00,2020-01-22 10:00:00,24.0,260,11,2,255,10,1,1,1,0,2020-01-21
2020-01-21 10:20:00,2020-01-24 21:20:00,83.0,260,11,2,255,8,1,1,3,0,2020-01-21
2020-01-21 11:25:00,2020-01-22 11:25:00,24.0,260,11,1,255,10,1,0,1,0,2020-01-21
2020-01-21 13:15:00,2020-01-22 13:15:00,24.0,260,11,1,255,10,1,0,1,0,2020-01-21
2020-01-21 18:45:00,2020-01-21 19:45:00,1.0,260,11,1,255,8,1,0,3,0,2020-01-21
2020-01-22 07:50:00,2020-01-23 07:50:00,24.0,260,6,1,255,5,1,0,1,0,2020-01-22
2020-01-22 08:30:00,2020-01-23 08:30:00,24.0,260,6,2,255,5,2,0,1,0,2020-01-22
2020-01-22 09:00:00,2020-01-23 09:00:00,24.0,260,6,1,255,5,1,0,1,0,2020-01-22
2020-01-22 13:15:00,2020-01-22 14:15:00,1.0,260,6,2,255,10,1,1,-4,0,2020-01-22
2020-01-22 13:30:00,2020-01-23 13:30:00,24.0,260,6,2,255,5,1,1,1,0,2020-01-22
2020-01-23 09:00:00,2020-01-24 09:00:00,24.0,260,5,4,255,8,5,-1,-3,0,2020-01-23
2020-01-23 09:05:00,2020-01-24 09:05:00,24.0,260,5,4,255,8,5,-1,-3,0,2020-01-23
2020-01-23 09:15:00,2020-01-24 09:15:00,24.0,260,5,4,255,8,5,-1,-3,0,2020-01-23
2020-01-23 09:30:00,2020-01-24 09:30:00,24.0,260,5,4,255,8,5,-1,-3,0,2020-01-23
2020-01-23 17:40:00,2020-01-24 17:40:00,24.0,260,5,1,255,8,1,0,-3,0,2020-01-23
2020-01-24 01:00:00,2020-02-24 01:00:00,744.0,260,8,1,224,3,1,0,5,0,2020-01-24
2020-01-24 07:30:00,2020-01-25 07:30:00,24.0,260,8,2,255,5,2,0,3,0,2020-01-24
2020-01-24 07:50:00,2020-01-25 07:50:00,24.0,260,8,2,255,5,2,0,3,0,2020-01-24
2020-01-24 08:25:00,2020-01-25 08:25:00,24.0,260,8,2,255,5,1,1,3,0,2020-01-24
2020-01-24 08:55:00,2020-01-24 09:55:00,1.0,260,8,2,255,8,5,-3,0,0,2020-01-24
2020-01-24 09:10:00,2020-01-24 10:10:00,1.0,260,8,2,255,8,1,1,0,0,2020-01-24
2020-01-24 09:15:00,2020-01-25 09:15:00,24.0,260,8,2,255,5,1,1,3,0,2020-01-24
2020-01-24 10:05:00,2020-01-25 10:05:00,24.0,260,8,1,255,5,1,0,3,0,2020-01-24
2020-01-27 07:00:00,2020-01-27 16:00:00,9.0,260,10,2,255,6,2,0,4,0,2020-01-27
2020-01-27 07:50:00,2020-01-28 07:50:00,24.0,260,10,2,255,8,1,1,2,0,2020-01-27
2020-01-27 08:10:00,2020-01-28 08:10:00,24.0,260,10,4,255,8,4,0,2,0,2020-01-27
2020-01-27 08:40:00,2020-01-28 08:40:00,24.0,260,10,4,255,8,4,0,2,0,2020-01-27
2020-01-27 15:50:00,2020-01-27 21:50:00,6.0,260,10,1,255,6,1,0,4,0,2020-01-27
2020-01-28 07:30:00,2020-01-29 07:30:00,24.0,260,13,3,255,12,3,0,1,0,2020-01-28
2020-01-28 08:05:00,2020-01-29 08:05:00,24.0,260,13,6,255,12,5,1,1,0,2020-01-28
2020-01-28 08:35:00,2020-01-29 08:35:00,24.0,260,13,6,255,12,5,1,1,0,2020-01-28
2020-01-28 08:35:00,2020-01-29 08:35:00,24.0,260,13,6,255,12,5,1,1,0,2020-01-28
2020-01-28 09:00:00,2020-01-29 09:00:00,24.0,260,13,2,255,12,2,0,1,0,2020-01-28
2020-01-28 09:20:00,2020-01-29 09:20:00,24.0,260,13,2,255,12,2,0,1,0,2020-01-28
2020-01-29 08:05:00,2020-01-30 08:05:00,24.0,260,7,4,255,7,4,0,0,0,2020-01-29
2020-01-29 08:10:00,2020-01-30 08:10:00,24.0,260,7,4,255,7,4,0,0,0,2020-01-29
2020-01-29 08:35:00,2020-01-30 08:35:00,24.0,260,7,4,255,7,4,0,0,0,2020-01-29
2020-01-29 09:10:00,2020-01-30 09:10:00,24.0,260,7,1,255,7,1,0,0,0,2020-01-29
2020-01-29 10:00:00,2020-01-30 10:00:00,24.0,260,7,1,255,7,1,0,0,0,2020-01-29
2020-01-30 07:00:00,2020-01-30 17:00:00,10.0,260,14,1,255,7,1,0,7,0,2020-01-30
2020-01-30 08:05:00,2020-01-31 08:05:00,24.0,260,14,7,255,17,7,0,-3,0,2020-01-30
2020-01-30 08:10:00,2020-01-31 08:10:00,24.0,260,14,7,255,17,7,0,-3,0,2020-01-30
2020-01-30 08:30:00,2020-01-31 08:30:00,24.0,260,14,7,255,17,7,0,-3,0,2020-01-30
2020-01-30 08:35:00,2020-01-31 08:35:00,24.0,260,14,7,255,17,7,0,-3,0,2020-01-30
2020-01-30 08:40:00,2020-01-31 08:40:00,24.0,260,14,7,255,17,7,0,-3,0,2020-01-30
2020-01-30 08:40:00,2020-01-31 08:40:00,24.0,260,14,7,255,17,7,0,-3,0,2020-01-30
2020-01-30 08:50:00,2020-01-31 08:50:00,24.0,260,14,7,255,17,7,0,-3,0,2020-01-30
2020-01-30 09:00:00,2020-01-31 09:00:00,24.0,260,14,2,255,17,2,0,-3,0,2020-01-30
2020-01-30 09:10:00,2020-01-31 09:10:00,24.0,260,14,2,255,17,2,0,-3,0,2020-01-30
2020-01-30 17:40:00,2020-01-31 17:40:00,24.0,260,14,1,255,17,2,-1,-3,0,2020-01-30
2020-01-31 07:00:00,2020-01-31 17:00:00,10.0,260,9,1,255,17,2,-1,-8,0,2020-01-31
2020-01-31 08:15:00,2020-02-01 08:15:00,24.0,260,9,2,224,7,2,0,2,0,2020-01-31
2020-01-31 08:25:00,2020-02-01 08:25:00,24.0,260,9,2,224,7,2,0,2,0,2020-01-31
2020-01-31 09:05:00,2020-02-01 09:05:00,24.0,260,9,3,224,7,3,0,2,0,2020-01-31
2020-01-31 09:20:00,2020-02-01 09:20:00,24.0,260,9,3,224,7,3,0,2,0,2020-01-31
2020-01-31 09:30:00,2020-02-01 09:30:00,24.0,260,9,3,224,7,3,0,2,0,2020-01-31
2020-01-31 10:10:00,2020-01-31 12:10:00,2.0,260,9,1,255,17,2,-1,-8,0,2020-01-31
2020-02-01 07:20:00,2020-02-01 17:20:00,10.0,219,9,2,224,7,1,1,2,2,2020-02-01
2020-02-01 08:20:00,2020-02-02 08:20:00,24.0,219,9,3,224,7,2,1,2,2,2020-02-01
2020-02-01 13:05:00,2020-02-02 13:05:00,24.0,219,9,1,224,7,1,0,2,2,2020-02-01
2020-02-03 08:15:00,2020-02-10 08:15:00,168.0,219,9,4,224,3,1,3,6,0,2020-02-03
2020-02-03 08:20:00,2020-02-04 08:20:00,24.0,219,9,4,224,8,3,1,1,0,2020-02-03
2020-02-03 08:25:00,2020-02-04 08:25:00,24.0,219,9,4,224,8,3,1,1,0,2020-02-03
2020-02-04 07:40:00,2020-02-05 07:40:00,24.0,219,12,2,224,12,2,0,0,0,2020-02-04
2020-02-04 07:45:00,2020-02-05 07:45:00,24.0,219,12,2,224,12,2,0,0,0,2020-02-04
2020-02-04 08:25:00,2020-02-08 08:25:00,96.0,219,12,4,224,9,4,0,3,0,2020-02-04
2020-02-04 08:35:00,2020-02-05 08:35:00,24.0,219,12,4,224,12,3,1,0,0,2020-02-04
2020-02-04 09:25:00,2020-02-05 09:25:00,24.0,219,12,3,224,12,3,0,0,0,2020-02-04
2020-02-04 09:40:00,2020-02-05 09:40:00,24.0,219,12,3,224,12,3,0,0,0,2020-02-04
2020-02-04 09:55:00,2020-02-05 09:55:00,24.0,219,12,3,224,12,3,0,0,0,2020-02-04
2020-02-04 12:50:00,2020-02-05 12:50:00,24.0,219,12,2,224,12,2,0,0,0,2020-02-04
2020-02-05 07:25:00,2020-02-06 07:25:00,24.0,219,12,3,224,10,3,0,2,0,2020-02-05
2020-02-05 07:45:00,2020-02-06 07:45:00,24.0,219,12,3,224,10,3,0,2,0,2020-02-05
2020-02-05 07:55:00,2020-02-06 07:55:00,24.0,219,12,3,224,10,3,0,2,0,2020-02-05
2020-02-05 08:00:00,2020-02-06 08:00:00,24.0,219,12,4,224,10,4,0,2,0,2020-02-05
2020-02-05 08:20:00,2020-02-06 08:20:00,24.0,219,12,4,224,10,4,0,2,0,2020-02-05
2020-02-05 09:00:00,2020-02-06 09:00:00,24.0,219,12,2,224,10,2,0,2,0,2020-02-05
2020-02-05 09:20:00,2020-02-06 09:20:00,24.0,219,12,2,224,10,2,0,2,0,2020-02-05
2020-02-05 17:45:00,2020-02-05 23:45:00,6.0,219,12,1,224,12,1,0,0,0,2020-02-05
2020-02-06 01:00:00,2020-03-06 01:00:00,696.0,219,10,1,129,12,1,0,-2,0,2020-02-06
2020-02-06 07:10:00,2020-02-07 07:10:00,24.0,219,10,3,224,11,3,0,-1,0,2020-02-06
2020-02-06 07:25:00,2020-02-07 07:25:00,24.0,219,10,3,224,11,3,0,-1,0,2020-02-06
2020-02-06 07:55:00,2020-02-07 07:55:00,24.0,219,10,3,224,11,3,0,-1,0,2020-02-06
2020-02-06 08:10:00,2020-02-07 08:10:00,24.0,219,10,2,224,11,2,0,-1,0,2020-02-06
2020-02-06 08:45:00,2020-02-07 08:45:00,24.0,219,10,2,224,11,2,0,-1,0,2020-02-06
2020-02-06 09:10:00,2020-02-07 09:10:00,24.0,219,10,3,224,11,3,0,-1,0,2020-02-06
2020-02-06 09:15:00,2020-02-07 09:15:00,24.0,219,10,3,224,11,3,0,-1,0,2020-02-06
2020-02-06 09:20:00,2020-02-07 09:20:00,24.0,219,10,3,224,11,3,0,-1,0,2020-02-06
2020-02-06 11:50:00,2020-02-07 11:50:00,24.0,219,10,1,224,11,1,0,-1,0,2020-02-06
2020-02-07 07:25:00,2020-02-08 00:25:00,17.0,219,6,1,224,9,1,0,-3,0,2020-02-07
2020-02-07 08:25:00,2020-02-08 08:25:00,24.0,219,6,3,224,9,4,-1,-3,0,2020-02-07
2020-02-07 08:25:00,2020-02-08 08:25:00,24.0,219,6,3,224,9,4,-1,-3,0,2020-02-07
2020-02-07 08:30:00,2020-02-08 08:30:00,24.0,219,6,3,224,9,4,-1,-3,0,2020-02-07
2020-02-07 10:05:00,2020-02-08 10:05:00,24.0,219,6,1,224,9,1,0,-3,0,2020-02-07
2020-02-07 16:40:00,2020-02-07 17:40:00,1.0,219,6,1,224,11,1,0,-5,0,2020-02-07
2020-02-08 08:25:00,2020-02-09 08:25:00,24.0,219,7,3,224,6,2,1,1,0,2020-02-08
2020-02-09 10:20:00,2020-02-10 10:20:00,24.0,219,3,1,224,3,1,0,0,0,2020-02-09
2020-02-10 00:20:00,2020-02-14 00:20:00,96.0,219,14,1,224,8,1,0,6,0,2020-02-10
2020-02-10 06:20:00,2020-02-11 06:20:00,24.0,219,14,1,224,12,1,0,2,0,2020-02-10
2020-02-10 07:40:00,2020-02-11 07:40:00,24.0,219,14,1,224,12,1,0,2,0,2020-02-10
2020-02-10 08:15:00,2020-02-11 08:15:00,24.0,219,14,6,224,12,5,1,2,0,2020-02-10
2020-02-10 08:15:00,2020-02-11 18:15:00,34.0,219,14,6,224,12,1,5,2,0,2020-02-10
2020-02-10 08:30:00,2020-02-11 08:30:00,24.0,219,14,6,224,12,5,1,2,0,2020-02-10
2020-02-10 09:05:00,2020-02-11 09:05:00,24.0,219,14,2,224,12,2,0,2,0,2020-02-10
2020-02-10 10:15:00,2020-02-14 21:15:00,107.0,219,14,1,224,8,1,0,6,0,2020-02-10
2020-02-10 12:40:00,2020-02-11 12:40:00,24.0,219,14,1,224,12,1,0,2,0,2020-02-10
2020-02-11 06:50:00,2020-02-12 06:50:00,24.0,219,11,1,224,10,1,0,1,5,2020-02-11
2020-02-11 07:55:00,2020-02-12 07:55:00,24.0,219,11,2,224,10,2,0,1,5,2020-02-11
2020-02-11 08:15:00,2020-02-12 08:15:00,24.0,219,11,4,224,10,4,0,1,5,2020-02-11
2020-02-11 08:20:00,2020-02-12 08:20:00,24.0,219,11,4,224,10,4,0,1,5,2020-02-11
2020-02-11 08:30:00,2020-02-12 08:30:00,24.0,219,11,4,224,10,4,0,1,5,2020-02-11
2020-02-11 08:55:00,2020-02-12 08:55:00,24.0,219,11,4,224,10,4,0,1,5,2020-02-11
2020-02-11 14:00:00,2020-02-11 19:00:00,5.0,219,11,1,224,12,1,0,-1,5,2020-02-11
2020-02-11 15:10:00,2020-02-12 15:10:00,24.0,219,11,2,224,10,2,0,1,5,2020-02-11
2020-02-12 07:25:00,2020-02-13 07:25:00,24.0,219,12,3,224,12,3,0,0,0,2020-02-12
2020-02-12 07:30:00,2020-02-13 07:30:00,24.0,219,12,3,224,12,3,0,0,0,2020-02-12
2020-02-12 08:10:00,2020-02-13 08:10:00,24.0,219,12,6,224,12,5,1,0,0,2020-02-12
2020-02-12 08:25:00,2020-02-13 08:25:00,24.0,219,12,6,224,12,5,1,0,0,2020-02-12
2020-02-12 08:35:00,2020-02-13 08:35:00,24.0,219,12,6,224,12,5,1,0,0,2020-02-12
2020-02-12 09:25:00,2020-02-13 09:25:00,24.0,219,12,2,224,12,2,0,0,0,2020-02-12
2020-02-13 06:45:00,2020-02-14 06:45:00,24.0,219,6,1,224,8,1,0,-2,0,2020-02-13
2020-02-13 08:10:00,2020-02-14 08:10:00,24.0,219,6,2,224,8,2,0,-2,0,2020-02-13
2020-02-13 08:45:00,2020-02-14 08:45:00,24.0,219,6,2,224,8,2,0,-2,0,2020-02-13
2020-02-13 09:05:00,2020-02-14 09:05:00,24.0,219,6,1,224,8,1,0,-2,0,2020-02-13
2020-02-14 07:30:00,2020-02-15 07:30:00,24.0,219,2,1,224,5,1,0,-3,5,2020-02-14
2020-02-14 08:30:00,2020-02-15 08:30:00,24.0,219,2,1,224,5,1,0,-3,5,2020-02-14
2020-02-15 08:25:00,2020-02-16 08:25:00,24.0,219,8,3,224,6,2,1,2,0,2020-02-15
2020-02-17 07:00:00,2020-02-22 19:00:00,132.0,219,10,4,224,6,1,3,4,0,2020-02-17
2020-02-17 07:20:00,2020-02-18 07:20:00,24.0,219,10,4,224,11,3,1,-1,0,2020-02-17
2020-02-17 07:45:00,2020-02-18 07:45:00,24.0,219,10,4,224,11,3,1,-1,0,2020-02-17
2020-02-17 09:05:00,2020-02-18 09:05:00,24.0,219,10,2,224,11,2,0,-1,0,2020-02-17
2020-02-17 13:40:00,2020-02-18 13:40:00,24.0,219,10,1,224,11,1,0,-1,0,2020-02-17
2020-02-18 08:30:00,2020-02-19 08:30:00,24.0,219,11,5,224,10,4,1,1,0,2020-02-18
2020-02-18 08:30:00,2020-02-19 08:30:00,24.0,219,11,5,224,10,4,1,1,0,2020-02-18
2020-02-18 08:55:00,2020-02-19 08:55:00,24.0,219,11,5,224,10,4,1,1,0,2020-02-18
2020-02-18 12:35:00,2020-02-19 12:35:00,24.0,219,11,1,224,10,1,0,1,0,2020-02-18
2020-02-19 06:45:00,2020-02-20 06:45:00,24.0,219,12,1,224,10,1,0,2,0,2020-02-19
2020-02-19 08:30:00,2020-02-20 08:30:00,24.0,219,12,5,224,10,5,0,2,0,2020-02-19
2020-02-19 08:30:00,2020-02-20 08:30:00,24.0,219,12,5,224,10,5,0,2,0,2020-02-19
2020-02-19 09:05:00,2020-02-20 09:05:00,24.0,219,12,3,224,10,3,0,2,0,2020-02-19
2020-02-19 11:15:00,2020-02-19 15:15:00,4.0,219,12,1,224,10,1,0,2,0,2020-02-19
2020-02-19 13:05:00,2020-02-20 13:05:00,24.0,219,12,1,224,10,1,0,2,0,2020-02-19
2020-02-20 08:15:00,2020-02-21 08:15:00,24.0,219,7,3,224,9,3,0,-2,0,2020-02-20
2020-02-20 08:25:00,2020-02-21 08:25:00,24.0,219,7,3,224,9,3,0,-2,0,2020-02-20
2020-02-20 08:30:00,2020-02-21 08:30:00,24.0,219,7,3,224,9,3,0,-2,0,2020-02-20
2020-02-20 09:00:00,2020-02-21 09:00:00,24.0,219,7,1,224,9,1,0,-2,0,2020-02-20
2020-02-20 14:40:00,2020-02-21 14:40:00,24.0,219,7,1,224,9,1,0,-2,0,2020-02-20
2020-02-20 16:10:00,2020-02-21 16:10:00,24.0,219,7,1,224,9,1,0,-2,0,2020-02-20
2020-02-20 17:40:00,2020-02-21 17:40:00,24.0,219,7,1,224,9,1,0,-2,0,2020-02-20
2020-02-21 06:35:00,2020-02-22 06:35:00,24.0,219,6,1,224,6,1,0,0,0,2020-02-21
2020-02-21 08:45:00,2020-02-22 08:45:00,24.0,219,6,2,224,6,2,0,0,0,2020-02-21
2020-02-21 08:55:00,2020-02-22 08:55:00,24.0,219,6,2,224,6,2,0,0,0,2020-02-21
2020-02-21 18:15:00,2020-02-21 19:15:00,1.0,219,6,1,224,9,1,0,-3,0,2020-02-21
2020-02-22 08:30:00,2020-02-23 08:30:00,24.0,219,6,3,224,5,3,0,1,0,2020-02-22
2020-02-22 08:50:00,2020-02-23 08:50:00,24.0,219,6,3,224,5,3,0,1,0,2020-02-22
2020-02-22 13:00:00,2020-02-22 15:00:00,2.0,219,6,1,224,6,1,0,0,0,2020-02-22
2020-02-23 11:00:00,2020-02-24 21:00:00,34.0,219,2,1,224,3,1,0,-1,0,2020-02-23
2020-02-23 21:00:00,2020-02-28 21:00:00,120.0,219,2,1,224,11,2,-1,-9,0,2020-02-23
2020-02-24 07:30:00,2020-02-24 16:30:00,9.0,219,6,1,224,3,1,0,3,0,2020-02-24
2020-02-24 08:00:00,2020-02-25 08:00:00,24.0,219,6,3,224,6,3,0,0,0,2020-02-24
2020-02-24 08:05:00,2020-02-25 08:05:00,24.0,219,6,3,224,6,3,0,0,0,2020-02-24
2020-02-24 08:35:00,2020-02-25 08:35:00,24.0,219,6,3,224,6,3,0,0,0,2020-02-24
2020-02-24 09:10:00,2020-02-25 09:10:00,24.0,219,6,1,224,6,1,0,0,0,2020-02-24
2020-02-24 15:15:00,2020-02-25 15:15:00,24.0,219,6,1,224,6,1,0,0,0,2020-02-24
2020-02-25 07:20:00,2020-02-26 07:20:00,24.0,219,8,1,224,7,1,0,1,0,2020-02-25
2020-02-25 08:10:00,2020-02-26 08:10:00,24.0,219,8,3,224,7,3,0,1,0,2020-02-25
2020-02-25 08:15:00,2020-02-26 08:15:00,24.0,219,8,3,224,7,3,0,1,0,2020-02-25
2020-02-25 08:40:00,2020-02-26 08:40:00,24.0,219,8,3,224,7,3,0,1,0,2020-02-25
2020-02-25 09:00:00,2020-02-26 09:00:00,24.0,219,8,3,224,7,2,1,1,0,2020-02-25
2020-02-25 09:10:00,2020-02-25 19:10:00,10.0,219,8,3,224,6,1,2,2,0,2020-02-25
2020-02-25 09:20:00,2020-02-26 09:20:00,24.0,219,8,3,224,7,2,1,1,0,2020-02-25
2020-02-25 12:10:00,2020-02-26 12:10:00,24.0,219,8,1,224,7,1,0,1,0,2020-02-25
2020-02-26 00:15:00,2020-02-27 00:15:00,24.0,219,7,1,224,7,1,0,0,0,2020-02-26
2020-02-26 07:25:00,2020-02-27 07:25:00,24.0,219,7,2,224,7,2,0,0,0,2020-02-26
2020-02-26 07:25:00,2020-02-27 07:25:00,24.0,219,7,2,224,7,2,0,0,0,2020-02-26
2020-02-26 08:30:00,2020-02-27 08:30:00,24.0,219,7,3,224,7,3,0,0,0,2020-02-26
2020-02-26 08:30:00,2020-02-27 08:30:00,24.0,219,7,3,224,7,3,0,0,0,2020-02-26
2020-02-26 08:45:00,2020-02-27 08:45:00,24.0,219,7,3,224,7,3,0,0,0,2020-02-26
2020-02-26 09:10:00,2020-02-28 21:10:00,60.0,219,7,1,224,11,2,-1,-4,0,2020-02-26
2020-02-27 01:00:00,2020-03-27 01:00:00,696.0,219,10,1,129,8,1,0,2,0,2020-02-27
2020-02-27 07:05:00,2020-02-28 07:05:00,24.0,219,10,1,224,11,1,0,-1,0,2020-02-27
2020-02-27 08:15:00,2020-02-28 08:15:00,24.0,219,10,5,224,11,5,0,-1,0,2020-02-27
2020-02-27 08:15:00,2020-02-28 08:15:00,24.0,219,10,5,224,11,5,0,-1,0,2020-02-27
2020-02-27 08:30:00,2020-02-28 08:30:00,24.0,219,10,5,224,11,5,0,-1,0,2020-02-27
2020-02-27 08:40:00,2020-02-28 08:40:00,24.0,219,10,5,224,11,5,0,-1,0,2020-02-27
2020-02-27 08:50:00,2020-02-28 08:50:00,24.0,219,10,5,224,11,5,0,-1,0,2020-02-27
2020-02-27 09:20:00,2020-02-28 09:20:00,24.0,219,10,1,224,11,1,0,-1,0,2020-02-27
2020-02-27 13:40:00,2020-02-28 13:40:00,24.0,219,10,1,224,11,1,0,-1,0,2020-02-27
2020-02-27 17:45:00,2020-02-28 17:45:00,24.0,219,10,1,224,11,1,0,-1,0,2020-02-27
2020-02-28 07:30:00,2020-02-29 07:30:00,24.0,219,6,1,224,6,1,0,0,0,2020-02-28
2020-02-28 08:10:00,2020-02-29 08:10:00,24.0,219,6,2,224,6,2,0,0,0,2020-02-28
2020-02-28 08:25:00,2020-02-29 08:25:00,24.0,219,6,2,224,6,2,0,0,0,2020-02-28
2020-02-28 09:15:00,2020-02-29 09:15:00,24.0,219,6,2,224,6,2,0,0,0,2020-02-28
2020-02-28 09:50:00,2020-02-29 09:50:00,24.0,219,6,2,224,6,2,0,0,0,2020-02-28
2020-02-28 16:05:00,2020-02-29 16:05:00,24.0,219,6,1,224,6,1,0,0,0,2020-02-28
2020-02-29 08:25:00,2020-03-01 08:25:00,24.0,219,1,1,129,2,1,0,-1,0,2020-02-29
2020-03-02 07:45:00,2020-03-03 07:45:00,24.0,133,8,2,129,6,2,0,2,0,2020-03-02
2020-03-02 07:50:00,2020-03-03 07:50:00,24.0,133,8,2,129,6,2,0,2,0,2020-03-02
2020-03-02 08:00:00,2020-03-09 08:00:00,168.0,133,8,4,129,1,1,3,7,0,2020-03-02
2020-03-02 08:30:00,2020-03-03 08:30:00,24.0,133,8,4,129,6,3,1,2,0,2020-03-02
2020-03-02 08:30:00,2020-03-03 08:30:00,24.0,133,8,4,129,6,3,1,2,0,2020-03-02
2020-03-02 08:35:00,2020-03-03 08:35:00,24.0,133,8,4,129,6,3,1,2,0,2020-03-02
2020-03-02 09:10:00,2020-03-03 09:10:00,24.0,133,8,1,129,6,1,0,2,0,2020-03-02
2020-03-02 10:00:00,2020-03-06 21:00:00,107.0,133,8,1,129,12,2,-1,-4,0,2020-03-02
2020-03-03 01:00:00,2020-04-03 02:00:00,745.0,133,9,1,58,7,1,0,2,0,2020-03-03
2020-03-03 07:50:00,2020-03-04 07:50:00,24.0,133,9,2,129,8,2,0,1,0,2020-03-03
2020-03-03 07:50:00,2020-03-04 07:50:00,24.0,133,9,2,129,8,2,0,1,0,2020-03-03
2020-03-03 08:30:00,2020-03-04 08:30:00,24.0,133,9,3,129,8,3,0,1,0,2020-03-03
2020-03-03 08:35:00,2020-03-04 08:35:00,24.0,133,9,3,129,8,3,0,1,0,2020-03-03
2020-03-03 08:35:00,2020-03-04 08:35:00,24.0,133,9,3,129,8,3,0,1,0,2020-03-03
2020-03-03 09:00:00,2020-03-04 09:00:00,24.0,133,9,2,129,8,2,0,1,0,2020-03-03
2020-03-03 09:10:00,2020-03-04 09:10:00,24.0,133,9,2,129,8,2,0,1,0,2020-03-03
2020-03-03 19:55:00,2020-03-04 19:55:00,24.0,133,9,1,129,8,1,0,1,0,2020-03-03
2020-03-04 07:25:00,2020-03-05 07:25:00,24.0,133,7,3,129,7,3,0,0,0,2020-03-04
2020-03-04 07:35:00,2020-03-05 07:35:00,24.0,133,7,3,129,7,3,0,0,0,2020-03-04
2020-03-04 07:50:00,2020-03-05 07:50:00,24.0,133,7,3,129,7,3,0,0,0,2020-03-04
2020-03-04 08:30:00,2020-03-05 08:30:00,24.0,133,7,3,129,7,3,0,0,0,2020-03-04
2020-03-04 08:40:00,2020-03-05 08:40:00,24.0,133,7,3,129,7,3,0,0,0,2020-03-04
2020-03-04 08:55:00,2020-03-05 08:55:00,24.0,133,7,3,129,7,3,0,0,0,2020-03-04
2020-03-04 20:15:00,2020-03-05 20:15:00,24.0,133,7,1,129,7,1,0,0,0,2020-03-04
2020-03-05 07:15:00,2020-03-06 07:15:00,24.0,133,10,5,129,12,5,0,-2,0,2020-03-05
2020-03-05 07:25:00,2020-03-06 07:25:00,24.0,133,10,5,129,12,5,0,-2,0,2020-03-05
2020-03-05 07:35:00,2020-03-06 07:35:00,24.0,133,10,5,129,12,5,0,-2,0,2020-03-05
2020-03-05 07:45:00,2020-03-06 07:45:00,24.0,133,10,5,129,12,5,0,-2,0,2020-03-05
2020-03-05 07:55:00,2020-03-06 07:55:00,24.0,133,10,5,129,12,5,0,-2,0,2020-03-05
2020-03-05 08:10:00,2020-03-06 08:10:00,24.0,133,10,2,129,12,2,0,-2,0,2020-03-05
2020-03-05 08:25:00,2020-03-06 08:25:00,24.0,133,10,2,129,12,2,0,-2,0,2020-03-05
2020-03-05 13:40:00,2020-03-06 13:40:00,24.0,133,10,1,129,12,1,0,-2,0,2020-03-05
2020-03-05 17:45:00,2020-03-06 17:45:00,24.0,133,10,1,129,12,1,0,-2,0,2020-03-05
2020-03-05 21:55:00,2020-03-06 21:55:00,24.0,133,10,1,129,12,2,-1,-2,0,2020-03-05
2020-03-06 07:55:00,2020-03-07 07:55:00,24.0,133,2,1,129,2,1,0,0,0,2020-03-06
2020-03-06 22:40:00,2020-03-07 22:40:00,24.0,133,2,1,129,2,1,0,0,0,2020-03-06
2020-03-07 08:25:00,2020-03-08 08:25:00,24.0,133,1,1,129,1,1,0,0,0,2020-03-07
2020-03-08 01:00:00,2020-04-08 02:00:00,745.0,133,1,1,58,4,1,0,-3,0,2020-03-08
2020-03-09 07:50:00,2020-03-10 07:50:00,24.0,133,5,2,129,3,1,1,2,0,2020-03-09
2020-03-09 07:55:00,2020-03-14 07:55:00,120.0,133,5,2,129,7,4,-2,-2,0,2020-03-09
2020-03-09 08:30:00,2020-03-10 08:30:00,24.0,133,5,2,129,3,2,0,2,0,2020-03-09
2020-03-09 08:35:00,2020-03-10 08:35:00,24.0,133,5,2,129,3,2,0,2,0,2020-03-09
2020-03-09 09:45:00,2020-03-13 20:45:00,107.0,133,5,1,129,9,1,0,-4,0,2020-03-09
2020-03-10 06:40:00,2020-03-11 06:40:00,24.0,133,8,1,129,9,1,0,-1,0,2020-03-10
2020-03-10 07:20:00,2020-03-11 07:20:00,24.0,133,8,2,129,9,2,0,-1,0,2020-03-10
2020-03-10 07:55:00,2020-03-11 07:55:00,24.0,133,8,2,129,9,2,0,-1,0,2020-03-10
2020-03-10 08:00:00,2020-03-11 08:00:00,24.0,133,8,4,129,9,4,0,-1,0,2020-03-10
2020-03-10 08:15:00,2020-03-11 08:15:00,24.0,133,8,4,129,9,4,0,-1,0,2020-03-10
2020-03-10 08:25:00,2020-03-11 08:25:00,24.0,133,8,4,129,9,4,0,-1,0,2020-03-10
2020-03-10 08:30:00,2020-03-11 08:30:00,24.0,133,8,4,129,9,4,0,-1,0,2020-03-10
2020-03-10 09:45:00,2020-03-11 09:45:00,24.0,133,8,1,129,9,1,0,-1,0,2020-03-10
2020-03-11 07:20:00,2020-03-12 07:20:00,24.0,133,6,2,129,5,2,0,1,0,2020-03-11
2020-03-11 07:25:00,2020-03-12 07:25:00,24.0,133,6,2,129,5,2,0,1,0,2020-03-11
2020-03-11 08:25:00,2020-03-12 08:25:00,24.0,133,6,3,129,5,3,0,1,0,2020-03-11
2020-03-11 08:30:00,2020-03-12 08:30:00,24.0,133,6,3,129,5,3,0,1,0,2020-03-11
2020-03-11 08:30:00,2020-03-12 08:30:00,24.0,133,6,3,129,5,3,0,1,0,2020-03-11
2020-03-11 18:35:00,2020-03-11 19:35:00,1.0,133,6,1,129,9,1,0,-3,0,2020-03-11
2020-03-12 07:20:00,2020-03-13 07:20:00,24.0,133,7,4,129,9,4,0,-2,0,2020-03-12
2020-03-12 07:55:00,2020-03-13 07:55:00,24.0,133,7,4,129,9,4,0,-2,0,2020-03-12
2020-03-12 07:55:00,2020-03-13 07:55:00,24.0,133,7,4,129,9,4,0,-2,0,2020-03-12
2020-03-12 07:55:00,2020-03-13 07:55:00,24.0,133,7,4,129,9,4,0,-2,0,2020-03-12
2020-03-12 08:15:00,2020-03-13 08:15:00,24.0,133,7,1,129,9,1,0,-2,0,2020-03-12
2020-03-12 09:05:00,2020-03-13 09:05:00,24.0,133,7,1,129,9,1,0,-2,0,2020-03-12
2020-03-12 17:50:00,2020-03-13 17:50:00,24.0,133,7,1,129,9,1,0,-2,0,2020-03-12
2020-03-13 01:00:00,2020-04-13 02:00:00,745.0,133,8,1,58,1,1,0,7,0,2020-03-13
2020-03-13 07:20:00,2020-03-14 07:20:00,24.0,133,8,3,129,7,4,-1,1,0,2020-03-13
2020-03-13 07:45:00,2020-03-14 07:45:00,24.0,133,8,3,129,7,4,-1,1,0,2020-03-13
2020-03-13 07:50:00,2020-03-14 07:50:00,24.0,133,8,3,129,7,4,-1,1,0,2020-03-13
2020-03-13 08:15:00,2020-03-13 18:15:00,10.0,133,8,2,129,9,1,1,-1,0,2020-03-13
2020-03-13 08:25:00,2020-03-14 08:25:00,24.0,133,8,2,129,7,1,1,1,0,2020-03-13
2020-03-13 10:55:00,2020-03-14 10:55:00,24.0,133,8,1,129,7,1,0,1,0,2020-03-13
2020-03-13 12:10:00,2020-03-14 12:10:00,24.0,133,8,1,129,7,1,0,1,0,2020-03-13
2020-03-16 07:20:00,2020-03-17 07:20:00,24.0,133,5,4,129,5,4,0,0,0,2020-03-16
2020-03-16 07:25:00,2020-03-17 07:25:00,24.0,133,5,4,129,5,4,0,0,0,2020-03-16
2020-03-16 07:40:00,2020-03-17 07:40:00,24.0,133,5,4,129,5,4,0,0,0,2020-03-16
2020-03-16 07:55:00,2020-03-17 07:55:00,24.0,133,5,4,129,5,4,0,0,0,2020-03-16
2020-03-16 09:25:00,2020-03-17 09:25:00,24.0,133,5,1,129,5,1,0,0,0,2020-03-16
2020-03-17 07:15:00,2020-03-18 07:15:00,24.0,133,8,2,129,8,2,0,0,0,2020-03-17
2020-03-17 07:20:00,2020-03-18 07:20:00,24.0,133,8,2,129,8,2,0,0,0,2020-03-17
2020-03-17 08:00:00,2020-03-18 08:00:00,24.0,133,8,4,129,8,4,0,0,0,2020-03-17
2020-03-17 08:25:00,2020-03-18 08:25:00,24.0,133,8,4,129,8,4,0,0,0,2020-03-17
2020-03-17 08:35:00,2020-03-18 08:35:00,24.0,133,8,4,129,8,4,0,0,0,2020-03-17
2020-03-17 08:35:00,2020-03-18 08:35:00,24.0,133,8,4,129,8,4,0,0,0,2020-03-17
2020-03-17 09:55:00,2020-03-18 09:55:00,24.0,133,8,1,129,8,1,0,0,0,2020-03-17
2020-03-17 10:25:00,2020-03-18 10:25:00,24.0,133,8,1,129,8,1,0,0,0,2020-03-17
2020-03-18 07:40:00,2020-03-19 07:40:00,24.0,133,5,3,129,5,3,0,0,0,2020-03-18
2020-03-18 07:55:00,2020-03-19 07:55:00,24.0,133,5,3,129,5,3,0,0,0,2020-03-18
2020-03-18 07:55:00,2020-03-19 07:55:00,24.0,133,5,3,129,5,3,0,0,0,2020-03-18
2020-03-18 08:15:00,2020-03-19 08:15:00,24.0,133,5,1,129,5,1,0,0,0,2020-03-18
2020-03-18 13:30:00,2020-03-19 13:30:00,24.0,133,5,1,129,5,1,0,0,0,2020-03-18
2020-03-19 08:00:00,2020-03-20 08:00:00,24.0,133,6,6,129,5,5,1,1,0,2020-03-19
2020-03-19 08:10:00,2020-03-20 08:10:00,24.0,133,6,6,129,5,5,1,1,0,2020-03-19
2020-03-19 08:15:00,2020-03-20 08:15:00,24.0,133,6,6,129,5,5,1,1,0,2020-03-19
2020-03-19 08:20:00,2020-03-20 08:20:00,24.0,133,6,6,129,5,5,1,1,0,2020-03-19
2020-03-19 08:25:00,2020-03-21 08:25:00,48.0,133,6,6,129,5,2,4,1,0,2020-03-19
2020-03-19 08:35:00,2020-03-20 08:35:00,24.0,133,6,6,129,5,5,1,1,0,2020-03-19
2020-03-20 07:25:00,2020-03-21 07:25:00,24.0,133,4,1,129,5,1,0,-1,0,2020-03-20
2020-03-20 08:15:00,2020-03-21 08:15:00,24.0,133,4,1,129,5,2,-1,-1,0,2020-03-20
2020-03-20 10:05:00,2020-03-21 10:05:00,24.0,133,4,1,129,5,1,0,-1,0,2020-03-20
2020-03-20 19:55:00,2020-03-21 19:55:00,24.0,133,4,1,129,5,1,0,-1,0,2020-03-20
2020-03-21 20:45:00,2020-03-22 20:45:00,24.0,133,1,1,129,1,1,0,0,0,2020-03-21
2020-03-22 23:00:00,2020-03-23 23:00:00,24.0,133,1,1,129,1,1,0,0,0,2020-03-22
2020-03-23 07:50:00,2020-03-24 07:50:00,24.0,133,3,2,129,3,2,0,0,0,2020-03-23
2020-03-23 07:55:00,2020-03-24 07:55:00,24.0,133,3,2,129,3,2,0,0,0,2020-03-23
2020-03-23 08:35:00,2020-03-24 08:35:00,24.0,133,3,1,129,3,1,0,0,0,2020-03-23
2020-03-24 00:05:00,2020-03-25 00:05:00,24.0,133,6,1,129,6,1,0,0,0,2020-03-24
2020-03-24 06:45:00,2020-03-25 06:45:00,24.0,133,6,1,129,6,1,0,0,0,2020-03-24
2020-03-24 08:20:00,2020-03-25 08:20:00,24.0,133,6,3,129,6,3,0,0,0,2020-03-24
2020-03-24 08:30:00,2020-03-25 08:30:00,24.0,133,6,3,129,6,3,0,0,0,2020-03-24
2020-03-24 08:50:00,2020-03-25 08:50:00,24.0,133,6,3,129,6,3,0,0,0,2020-03-24
2020-03-24 09:15:00,2020-03-25 09:15:00,24.0,133,6,1,129,6,1,0,0,0,2020-03-24
2020-03-25 08:25:00,2020-03-26 08:25:00,24.0,133,3,3,129,4,3,0,-1,0,2020-03-25
2020-03-25 08:40:00,2020-03-26 08:40:00,24.0,133,3,3,129,4,3,0,-1,0,2020-03-25
2020-03-25 08:50:00,2020-03-26 08:50:00,24.0,133,3,3,129,4,3,0,-1,0,2020-03-25
2020-03-26 08:20:00,2020-03-27 08:20:00,24.0,133,7,4,129,8,4,0,-1,0,2020-03-26
2020-03-26 08:30:00,2020-03-27 08:30:00,24.0,133,7,4,129,8,4,0,-1,0,2020-03-26
2020-03-26 08:35:00,2020-03-27 08:35:00,24.0,133,7,4,129,8,4,0,-1,0,2020-03-26
2020-03-26 08:45:00,2020-03-27 08:45:00,24.0,133,7,4,129,8,4,0,-1,0,2020-03-26
2020-03-26 09:20:00,2020-03-27 09:20:00,24.0,133,7,2,129,8,2,0,-1,0,2020-03-26
2020-03-26 09:45:00,2020-03-27 09:45:00,24.0,133,7,2,129,8,2,0,-1,0,2020-03-26
2020-03-26 13:45:00,2020-03-26 17:45:00,4.0,133,7,1,129,4,1,0,3,0,2020-03-26
2020-03-27 09:00:00,2020-03-28 09:00:00,24.0,133,3,2,129,2,2,0,1,0,2020-03-27
2020-03-27 09:20:00,2020-03-28 09:20:00,24.0,133,3,2,129,2,2,0,1,0,2020-03-27
2020-03-27 12:50:00,2020-03-27 13:50:00,1.0,133,3,1,129,8,1,0,-5,0,2020-03-27
2020-03-30 09:55:00,2020-03-31 09:55:00,24.0,133,4,1,129,4,1,0,0,0,2020-03-30
2020-03-30 10:25:00,2020-03-31 10:25:00,24.0,133,4,2,129,4,2,0,0,0,2020-03-30
2020-03-30 10:55:00,2020-03-31 10:55:00,24.0,133,4,2,129,4,2,0,0,0,2020-03-30
2020-03-30 12:20:00,2020-03-31 12:20:00,24.0,133,4,1,129,4,1,0,0,0,2020-03-30
2020-03-31 09:35:00,2020-04-01 09:35:00,24.0,133,5,3,58,5,3,0,0,0,2020-03-31
2020-03-31 09:50:00,2020-04-01 09:50:00,24.0,133,5,3,58,5,3,0,0,0,2020-03-31
2020-03-31 09:55:00,2020-04-01 09:55:00,24.0,133,5,3,58,5,3,0,0,0,2020-03-31
2020-03-31 10:05:00,2020-04-01 10:05:00,24.0,133,5,2,58,5,1,1,0,0,2020-03-31
2020-03-31 10:25:00,2020-04-01 05:25:00,19.0,133,5,2,58,5,1,1,0,0,2020-03-31
2020-04-01 09:25:00,2020-04-02 09:25:00,24.0,56,3,2,58,3,2,0,0,0,2020-04-01
2020-04-01 09:40:00,2020-04-02 09:40:00,24.0,56,3,2,58,3,2,0,0,0,2020-04-01
2020-04-01 10:10:00,2020-04-02 10:10:00,24.0,56,3,1,58,3,1,0,0,0,2020-04-01
2020-04-02 09:25:00,2020-04-03 09:25:00,24.0,56,5,3,58,7,3,0,-2,0,2020-04-02
2020-04-02 09:35:00,2020-04-03 09:35:00,24.0,56,5,3,58,7,3,0,-2,0,2020-04-02
2020-04-02 09:50:00,2020-04-03 09:50:00,24.0,56,5,3,58,7,3,0,-2,0,2020-04-02
2020-04-02 10:25:00,2020-04-03 10:25:00,24.0,56,5,1,58,7,1,0,-2,0,2020-04-02
2020-04-02 11:30:00,2020-04-03 11:30:00,24.0,56,5,1,58,7,1,0,-2,0,2020-04-02
2020-04-03 10:00:00,2020-04-04 10:00:00,24.0,56,3,1,58,2,1,0,1,0,2020-04-03
2020-04-03 12:10:00,2020-04-04 12:10:00,24.0,56,3,1,58,2,1,0,1,0,2020-04-03
2020-04-03 13:20:00,2020-04-03 16:20:00,3.0,56,3,1,58,7,1,0,-4,0,2020-04-03
2020-04-06 08:50:00,2020-04-07 08:50:00,24.0,56,2,1,58,2,1,0,0,0,2020-04-06
2020-04-06 10:10:00,2020-04-07 10:10:00,24.0,56,2,1,58,2,1,0,0,0,2020-04-06
2020-04-07 09:20:00,2020-04-08 09:20:00,24.0,56,3,1,58,4,1,0,-1,0,2020-04-07
2020-04-07 10:20:00,2020-04-08 10:20:00,24.0,56,3,1,58,4,1,0,-1,0,2020-04-07
2020-04-07 11:05:00,2020-04-08 11:05:00,24.0,56,3,1,58,4,1,0,-1,0,2020-04-07
2020-04-08 02:00:00,2020-04-09 02:00:00,24.0,56,1,1,58,1,1,0,0,0,2020-04-08
2020-04-09 02:00:00,2020-05-09 02:00:00,720.0,56,1,1,174,7,1,0,-6,0,2020-04-09
2020-04-16 12:00:00,2020-04-16 13:00:00,1.0,56,1,1,58,1,1,0,0,0,2020-04-16
2020-04-17 09:55:00,2020-04-18 09:55:00,24.0,56,1,1,58,1,1,0,0,0,2020-04-17
2020-04-19 20:40:00,2020-04-20 20:40:00,24.0,56,1,1,58,1,1,0,0,0,2020-04-19
2020-04-20 09:25:00,2020-04-21 09:25:00,24.0,56,2,1,58,2,1,0,0,0,2020-04-20
2020-04-20 10:05:00,2020-04-21 10:05:00,24.0,56,2,1,58,2,1,0,0,0,2020-04-20
2020-04-21 09:25:00,2020-04-22 09:25:00,24.0,56,3,3,58,3,3,0,0,0,2020-04-21
2020-04-21 09:40:00,2020-04-22 09:40:00,24.0,56,3,3,58,3,3,0,0,0,2020-04-21
2020-04-21 09:40:00,2020-04-22 09:40:00,24.0,56,3,3,58,3,3,0,0,0,2020-04-21
2020-04-22 10:45:00,2020-04-23 10:45:00,24.0,56,2,1,58,3,1,0,-1,0,2020-04-22
2020-04-22 13:55:00,2020-04-23 13:55:00,24.0,56,2,1,58,3,1,0,-1,0,2020-04-22
2020-04-23 09:05:00,2020-04-24 09:05:00,24.0,56,5,4,58,4,4,0,1,0,2020-04-23
2020-04-23 09:10:00,2020-04-24 09:10:00,24.0,56,5,4,58,4,4,0,1,0,2020-04-23
2020-04-23 09:25:00,2020-04-24 09:25:00,24.0,56,5,4,58,4,4,0,1,0,2020-04-23
2020-04-23 09:50:00,2020-04-24 09:50:00,24.0,56,5,4,58,4,4,0,1,0,2020-04-23
2020-04-23 11:40:00,2020-04-23 19:40:00,8.0,56,5,1,58,3,1,0,2,0,2020-04-23
2020-04-24 00:55:00,2020-04-25 00:55:00,24.0,56,3,1,58,3,1,0,0,0,2020-04-24
2020-04-24 09:40:00,2020-04-25 09:40:00,24.0,56,3,2,58,3,2,0,0,0,2020-04-24
2020-04-24 09:40:00,2020-04-25 09:40:00,24.0,56,3,2,58,3,2,0,0,0,2020-04-24
2020-04-27 09:55:00,2020-04-28 09:55:00,24.0,56,4,1,58,4,1,0,0,0,2020-04-27
2020-04-27 10:00:00,2020-04-28 10:00:00,24.0,56,4,2,58,4,2,0,0,0,2020-04-27
2020-04-27 10:55:00,2020-04-28 10:55:00,24.0,56,4,2,58,4,2,0,0,0,2020-04-27
2020-04-27 16:40:00,2020-04-28 16:40:00,24.0,56,4,1,58,4,1,0,0,0,2020-04-27
2020-04-28 09:25:00,2020-04-29 09:25:00,24.0,56,7,3,58,7,3,0,0,0,2020-04-28
2020-04-28 09:30:00,2020-04-29 09:30:00,24.0,56,7,3,58,7,3,0,0,0,2020-04-28
2020-04-28 09:35:00,2020-04-29 09:35:00,24.0,56,7,3,58,7,3,0,0,0,2020-04-28
2020-04-28 10:30:00,2020-04-29 10:30:00,24.0,56,7,1,58,7,1,0,0,0,2020-04-28
2020-04-28 11:05:00,2020-04-29 11:05:00,24.0,56,7,2,58,7,2,0,0,0,2020-04-28
2020-04-28 11:45:00,2020-04-29 11:45:00,24.0,56,7,2,58,7,2,0,0,0,2020-04-28
2020-04-28 14:50:00,2020-04-29 14:50:00,24.0,56,7,1,58,7,1,0,0,0,2020-04-28
2020-04-29 09:25:00,2020-04-30 09:25:00,24.0,56,4,2,58,4,2,0,0,0,2020-04-29
2020-04-29 09:25:00,2020-04-30 09:25:00,24.0,56,4,2,58,4,2,0,0,0,2020-04-29
2020-04-29 10:30:00,2020-04-30 10:30:00,24.0,56,4,1,58,4,1,0,0,0,2020-04-29
2020-04-29 13:45:00,2020-04-30 13:45:00,24.0,56,4,1,58,4,1,0,0,0,2020-04-29
2020-04-30 09:55:00,2020-05-01 09:55:00,24.0,56,5,1,174,7,1,0,-2,0,2020-04-30
2020-04-30 10:00:00,2020-05-01 10:00:00,24.0,56,5,3,174,7,3,0,-2,0,2020-04-30
2020-04-30 10:10:00,2020-05-01 10:10:00,24.0,56,5,3,174,7,3,0,-2,0,2020-04-30
2020-04-30 10:55:00,2020-05-01 10:55:00,24.0,56,5,3,174,7,3,0,-2,0,2020-04-30
2020-04-30 15:40:00,2020-05-01 15:40:00,24.0,56,5,1,174,7,1,0,-2,0,2020-04-30
2020-05-01 09:25:00,2020-05-02 09:25:00,24.0,170,6,3,174,4,2,1,2,0,2020-05-01
2020-05-01 09:50:00,2020-05-02 09:50:00,24.0,170,6,3,174,4,2,1,2,0,2020-05-01
2020-05-01 09:55:00,2020-05-01 14:55:00,5.0,170,6,3,174,7,1,2,-1,0,2020-05-01
2020-05-01 10:05:00,2020-05-02 10:05:00,24.0,170,6,2,174,4,2,0,2,0,2020-05-01
2020-05-01 10:55:00,2020-05-02 10:55:00,24.0,170,6,2,174,4,2,0,2,0,2020-05-01
2020-05-01 16:15:00,2020-05-01 17:15:00,1.0,170,6,1,174,7,1,0,-1,0,2020-05-01
2020-05-02 20:45:00,2020-05-03 20:45:00,24.0,170,1,1,174,1,1,0,0,0,2020-05-02
2020-05-03 15:00:00,2020-05-04 15:00:00,24.0,170,1,1,174,1,1,0,0,0,2020-05-03
2020-05-04 09:25:00,2020-05-05 09:25:00,24.0,170,6,1,174,6,1,0,0,5,2020-05-04
2020-05-04 10:00:00,2020-05-05 10:00:00,24.0,170,6,3,174,6,3,0,0,5,2020-05-04
2020-05-04 10:10:00,2020-05-05 10:10:00,24.0,170,6,3,174,6,3,0,0,5,2020-05-04
2020-05-04 10:40:00,2020-05-05 10:40:00,24.0,170,6,3,174,6,3,0,0,5,2020-05-04
2020-05-04 12:55:00,2020-05-05 12:55:00,24.0,170,6,1,174,6,1,0,0,5,2020-05-04
2020-05-04 22:40:00,2020-05-05 22:40:00,24.0,170,6,1,174,6,1,0,0,5,2020-05-04
2020-05-05 09:40:00,2020-05-06 09:40:00,24.0,170,4,1,174,4,1,0,0,0,2020-05-05
2020-05-05 10:00:00,2020-05-06 10:00:00,24.0,170,4,1,174,4,1,0,0,0,2020-05-05
2020-05-05 12:55:00,2020-05-06 12:55:00,24.0,170,4,1,174,4,1,0,0,0,2020-05-05
2020-05-05 22:30:00,2020-05-06 22:30:00,24.0,170,4,1,174,4,1,0,0,0,2020-05-05
2020-05-06 09:25:00,2020-05-07 09:25:00,24.0,170,5,1,174,5,1,0,0,0,2020-05-06
2020-05-06 10:10:00,2020-05-07 10:10:00,24.0,170,5,1,174,5,1,0,0,0,2020-05-06
2020-05-06 12:55:00,2020-05-07 12:55:00,24.0,170,5,1,174,5,1,0,0,0,2020-05-06
2020-05-06 13:35:00,2020-05-07 13:35:00,24.0,170,5,1,174,5,1,0,0,0,2020-05-06
2020-05-06 14:30:00,2020-05-07 14:30:00,24.0,170,5,1,174,5,1,0,0,0,2020-05-06
2020-05-07 09:25:00,2020-05-08 09:25:00,24.0,170,6,2,174,6,2,0,0,0,2020-05-07
2020-05-07 09:45:00,2020-05-08 09:45:00,24.0,170,6,2,174,6,2,0,0,0,2020-05-07
2020-05-07 10:00:00,2020-05-08 10:00:00,24.0,170,6,2,174,6,2,0,0,0,2020-05-07
2020-05-07 10:40:00,2020-05-08 10:40:00,24.0,170,6,2,174,6,2,0,0,0,2020-05-07
2020-05-07 14:00:00,2020-05-08 14:00:00,24.0,170,6,2,174,6,2,0,0,0,2020-05-07
2020-05-07 14:30:00,2020-05-08 14:30:00,24.0,170,6,2,174,6,2,0,0,0,2020-05-07
2020-05-08 09:40:00,2020-05-09 09:40:00,24.0,170,5,2,174,7,2,0,-2,0,2020-05-08
2020-05-08 09:45:00,2020-05-09 09:45:00,24.0,170,5,2,174,7,2,0,-2,0,2020-05-08
2020-05-08 10:05:00,2020-05-09 10:05:00,24.0,170,5,3,174,7,3,0,-2,0,2020-05-08
2020-05-08 10:20:00,2020-05-09 10:20:00,24.0,170,5,3,174,7,3,0,-2,0,2020-05-08
2020-05-08 10:35:00,2020-05-09 10:35:00,24.0,170,5,3,174,7,3,0,-2,0,2020-05-08
2020-05-09 12:40:00,2020-05-09 14:40:00,2.0,170,1,1,174,7,1,0,-6,0,2020-05-09
2020-05-10 15:00:00,2020-05-10 19:00:00,4.0,170,1,1,174,1,1,0,0,0,2020-05-10
2020-05-11 02:00:00,2020-06-11 02:00:00,744.0,170,11,1,213,14,1,0,-3,0,2020-05-11
2020-05-11 03:15:00,2020-05-12 03:15:00,24.0,170,11,1,174,12,1,0,-1,0,2020-05-11
2020-05-11 08:05:00,2020-05-12 08:05:00,24.0,170,11,4,174,12,4,0,-1,0,2020-05-11
2020-05-11 08:15:00,2020-05-12 08:15:00,24.0,170,11,4,174,12,4,0,-1,0,2020-05-11
2020-05-11 08:35:00,2020-05-12 08:35:00,24.0,170,11,4,174,12,4,0,-1,0,2020-05-11
2020-05-11 08:40:00,2020-05-12 08:40:00,24.0,170,11,4,174,12,4,0,-1,0,2020-05-11
2020-05-11 09:05:00,2020-05-12 09:05:00,24.0,170,11,3,174,12,3,0,-1,0,2020-05-11
2020-05-11 09:20:00,2020-05-12 09:20:00,24.0,170,11,3,174,12,3,0,-1,0,2020-05-11
2020-05-11 09:55:00,2020-05-12 09:55:00,24.0,170,11,3,174,12,3,0,-1,0,2020-05-11
2020-05-11 10:40:00,2020-05-12 10:40:00,24.0,170,11,1,174,12,1,0,-1,0,2020-05-11
2020-05-11 11:40:00,2020-05-12 11:40:00,24.0,170,11,1,174,12,1,0,-1,0,2020-05-11
2020-05-12 03:15:00,2020-05-13 03:15:00,24.0,170,11,1,174,9,1,0,2,0,2020-05-12
2020-05-12 08:35:00,2020-05-13 08:35:00,24.0,170,11,2,174,9,2,0,2,0,2020-05-12
2020-05-12 08:45:00,2020-05-13 08:45:00,24.0,170,11,2,174,9,2,0,2,0,2020-05-12
2020-05-12 09:00:00,2020-05-12 20:00:00,11.0,170,11,6,174,12,1,5,-1,0,2020-05-12
2020-05-12 09:10:00,2020-05-13 09:10:00,24.0,170,11,6,174,9,4,2,2,0,2020-05-12
2020-05-12 09:25:00,2020-05-13 09:25:00,24.0,170,11,6,174,9,4,2,2,0,2020-05-12
2020-05-12 09:30:00,2020-05-13 09:30:00,24.0,170,11,6,174,9,4,2,2,0,2020-05-12
2020-05-12 09:30:00,2020-05-13 09:30:00,24.0,170,11,6,174,9,4,2,2,0,2020-05-12
2020-05-12 09:55:00,2020-05-12 18:55:00,9.0,170,11,6,174,12,1,5,-1,0,2020-05-12
2020-05-12 12:25:00,2020-05-13 12:25:00,24.0,170,11,1,174,9,1,0,2,0,2020-05-12
2020-05-12 15:35:00,2020-05-13 15:35:00,24.0,170,11,1,174,9,1,0,2,0,2020-05-12
2020-05-13 03:15:00,2020-05-14 03:15:00,24.0,170,7,1,174,8,1,0,-1,0,2020-05-13
2020-05-13 09:15:00,2020-05-14 09:15:00,24.0,170,7,2,174,8,2,0,-1,0,2020-05-13
2020-05-13 09:20:00,2020-05-14 09:20:00,24.0,170,7,2,174,8,2,0,-1,0,2020-05-13
2020-05-13 10:05:00,2020-05-14 10:05:00,24.0,170,7,2,174,8,2,0,-1,0,2020-05-13
2020-05-13 10:10:00,2020-05-14 10:10:00,24.0,170,7,2,174,8,2,0,-1,0,2020-05-13
2020-05-13 15:35:00,2020-05-14 15:35:00,24.0,170,7,2,174,8,2,0,-1,0,2020-05-13
2020-05-13 15:55:00,2020-05-14 15:55:00,24.0,170,7,2,174,8,2,0,-1,0,2020-05-13
2020-05-14 08:45:00,2020-05-14 19:45:00,11.0,170,8,1,174,8,1,0,0,0,2020-05-14
2020-05-14 09:00:00,2020-05-15 09:00:00,24.0,170,8,3,174,8,3,0,0,0,2020-05-14
2020-05-14 09:25:00,2020-05-15 09:25:00,24.0,170,8,3,174,8,3,0,0,0,2020-05-14
2020-05-14 09:40:00,2020-05-15 09:40:00,24.0,170,8,3,174,8,3,0,0,0,2020-05-14
2020-05-14 10:10:00,2020-05-15 10:10:00,24.0,170,8,1,174,8,1,0,0,0,2020-05-14
2020-05-14 11:10:00,2020-05-15 11:10:00,24.0,170,8,1,174,8,1,0,0,0,2020-05-14
2020-05-14 17:15:00,2020-05-15 17:15:00,24.0,170,8,1,174,8,1,0,0,0,2020-05-14
2020-05-14 20:00:00,2020-05-21 20:00:00,168.0,170,8,1,174,8,1,0,0,0,2020-05-14
2020-05-15 08:40:00,2020-05-16 08:40:00,24.0,170,9,1,174,7,1,0,2,0,2020-05-15
2020-05-15 09:25:00,2020-05-16 09:25:00,24.0,170,9,3,174,7,3,0,2,0,2020-05-15
2020-05-15 09:30:00,2020-05-16 09:30:00,24.0,170,9,3,174,7,3,0,2,0,2020-05-15
2020-05-15 09:50:00,2020-05-16 09:50:00,24.0,170,9,3,174,7,3,0,2,0,2020-05-15
2020-05-15 10:00:00,2020-05-16 10:00:00,24.0,170,9,2,174,7,2,0,2,0,2020-05-15
2020-05-15 10:55:00,2020-05-16 10:55:00,24.0,170,9,2,174,7,2,0,2,0,2020-05-15
2020-05-15 12:00:00,2020-05-15 13:00:00,1.0,170,9,1,174,8,1,0,1,0,2020-05-15
2020-05-15 14:20:00,2020-05-15 18:20:00,4.0,170,9,1,174,8,1,0,1,0,2020-05-15
2020-05-15 19:55:00,2020-05-16 19:55:00,24.0,170,9,1,174,7,1,0,2,0,2020-05-15
2020-05-16 11:35:00,2020-05-17 11:35:00,24.0,170,2,1,174,2,1,0,0,0,2020-05-16
2020-05-16 16:50:00,2020-05-17 16:50:00,24.0,170,2,1,174,2,1,0,0,0,2020-05-16
2020-05-18 08:20:00,2020-05-19 08:20:00,24.0,170,10,2,174,10,2,0,0,0,2020-05-18
2020-05-18 08:40:00,2020-05-19 08:40:00,24.0,170,10,2,174,10,2,0,0,0,2020-05-18
2020-05-18 09:05:00,2020-05-19 09:05:00,24.0,170,10,6,174,10,6,0,0,0,2020-05-18
2020-05-18 09:05:00,2020-05-19 09:05:00,24.0,170,10,6,174,10,6,0,0,0,2020-05-18
2020-05-18 09:10:00,2020-05-19 09:10:00,24.0,170,10,6,174,10,6,0,0,0,2020-05-18
2020-05-18 09:30:00,2020-05-19 09:30:00,24.0,170,10,6,174,10,6,0,0,0,2020-05-18
2020-05-18 09:40:00,2020-05-19 09:40:00,24.0,170,10,6,174,10,6,0,0,0,2020-05-18
2020-05-18 09:45:00,2020-05-19 09:45:00,24.0,170,10,6,174,10,6,0,0,0,2020-05-18
2020-05-18 10:00:00,2020-05-19 10:00:00,24.0,170,10,2,174,10,2,0,0,0,2020-05-18
2020-05-18 10:50:00,2020-05-19 10:50:00,24.0,170,10,2,174,10,2,0,0,0,2020-05-18
2020-05-19 08:25:00,2020-05-20 08:25:00,24.0,170,10,3,174,11,3,0,-1,0,2020-05-19
2020-05-19 08:40:00,2020-05-20 08:40:00,24.0,170,10,3,174,11,3,0,-1,0,2020-05-19
2020-05-19 08:55:00,2020-05-20 08:55:00,24.0,170,10,3,174,11,3,0,-1,0,2020-05-19
2020-05-19 09:10:00,2020-05-20 09:10:00,24.0,170,10,5,174,11,5,0,-1,0,2020-05-19
2020-05-19 09:25:00,2020-05-20 09:25:00,24.0,170,10,5,174,11,5,0,-1,0,2020-05-19
2020-05-19 09:25:00,2020-05-20 09:25:00,24.0,170,10,5,174,11,5,0,-1,0,2020-05-19
2020-05-19 09:35:00,2020-05-20 09:35:00,24.0,170,10,5,174,11,5,0,-1,0,2020-05-19
2020-05-19 09:45:00,2020-05-20 09:45:00,24.0,170,10,5,174,11,5,0,-1,0,2020-05-19
2020-05-19 11:00:00,2020-05-20 11:00:00,24.0,170,10,1,174,11,1,0,-1,0,2020-05-19
2020-05-19 22:35:00,2020-05-20 22:35:00,24.0,170,10,1,174,11,1,0,-1,0,2020-05-19
2020-05-20 08:25:00,2020-05-21 08:25:00,24.0,170,8,2,174,8,2,0,0,0,2020-05-20
2020-05-20 08:35:00,2020-05-21 08:35:00,24.0,170,8,2,174,8,2,0,0,0,2020-05-20
2020-05-20 09:00:00,2020-05-21 09:00:00,24.0,170,8,4,174,8,4,0,0,0,2020-05-20
2020-05-20 09:25:00,2020-05-21 09:25:00,24.0,170,8,4,174,8,4,0,0,0,2020-05-20
2020-05-20 09:25:00,2020-05-21 09:25:00,24.0,170,8,4,174,8,4,0,0,0,2020-05-20
2020-05-20 09:45:00,2020-05-21 09:45:00,24.0,170,8,4,174,8,4,0,0,0,2020-05-20
2020-05-20 11:00:00,2020-05-20 14:00:00,3.0,170,8,1,174,11,1,0,-3,0,2020-05-20
2020-05-20 13:40:00,2020-05-21 13:40:00,24.0,170,8,1,174,8,1,0,0,0,2020-05-20
2020-05-21 20:40:00,2020-05-22 20:40:00,24.0,170,1,1,174,1,1,0,0,2,2020-05-21
2020-05-22 09:25:00,2020-05-23 09:25:00,24.0,170,4,1,174,4,1,0,0,0,2020-05-22
2020-05-22 10:35:00,2020-05-23 10:35:00,24.0,170,4,1,174,4,1,0,0,0,2020-05-22
2020-05-22 11:30:00,2020-05-29 11:30:00,168.0,170,4,1,174,8,1,0,-4,0,2020-05-22
2020-05-22 21:55:00,2020-05-23 21:55:00,24.0,170,4,1,174,4,1,0,0,0,2020-05-22
2020-05-23 00:55:00,2020-05-24 00:55:00,24.0,170,4,1,174,3,1,0,1,0,2020-05-23
2020-05-23 09:20:00,2020-05-24 09:20:00,24.0,170,4,1,174,3,1,0,1,0,2020-05-23
2020-05-23 13:25:00,2020-05-23 14:25:00,1.0,170,4,1,174,4,1,0,0,0,2020-05-23
2020-05-23 21:45:00,2020-05-24 21:45:00,24.0,170,4,1,174,3,1,0,1,0,2020-05-23
2020-05-24 01:00:00,2020-05-25 01:00:00,24.0,170,1,1,174,2,1,0,-1,0,2020-05-24
2020-05-25 08:25:00,2020-05-26 08:25:00,24.0,170,12,3,174,11,3,0,1,0,2020-05-25
2020-05-25 08:30:00,2020-05-26 08:30:00,24.0,170,12,3,174,11,3,0,1,0,2020-05-25
2020-05-25 08:50:00,2020-05-26 08:50:00,24.0,170,12,3,174,11,3,0,1,0,2020-05-25
2020-05-25 09:10:00,2020-05-26 09:10:00,24.0,170,12,5,174,11,5,0,1,0,2020-05-25
2020-05-25 09:15:00,2020-05-26 09:15:00,24.0,170,12,5,174,11,5,0,1,0,2020-05-25
2020-05-25 09:25:00,2020-05-26 09:25:00,24.0,170,12,5,174,11,5,0,1,0,2020-05-25
2020-05-25 09:25:00,2020-05-26 09:25:00,24.0,170,12,5,174,11,5,0,1,0,2020-05-25
2020-05-25 09:40:00,2020-05-26 09:40:00,24.0,170,12,5,174,11,5,0,1,0,2020-05-25
2020-05-25 10:00:00,2020-05-26 10:00:00,24.0,170,12,3,174,11,2,1,1,0,2020-05-25
2020-05-25 10:10:00,2020-05-25 14:10:00,4.0,170,12,3,174,2,1,2,10,0,2020-05-25
2020-05-25 10:30:00,2020-05-26 10:30:00,24.0,170,12,3,174,11,2,1,1,0,2020-05-25
2020-05-25 12:05:00,2020-05-26 12:05:00,24.0,170,12,1,174,11,1,0,1,0,2020-05-25
2020-05-26 08:20:00,2020-05-27 08:20:00,24.0,170,13,4,174,15,4,0,-2,0,2020-05-26
2020-05-26 08:25:00,2020-05-27 08:25:00,24.0,170,13,4,174,15,4,0,-2,0,2020-05-26
2020-05-26 08:30:00,2020-05-27 08:30:00,24.0,170,13,4,174,15,4,0,-2,0,2020-05-26
2020-05-26 08:45:00,2020-05-27 08:45:00,24.0,170,13,4,174,15,4,0,-2,0,2020-05-26
2020-05-26 09:20:00,2020-05-27 09:20:00,24.0,170,13,6,174,15,6,0,-2,0,2020-05-26
2020-05-26 09:30:00,2020-05-27 09:30:00,24.0,170,13,6,174,15,6,0,-2,0,2020-05-26
2020-05-26 09:35:00,2020-05-27 09:35:00,24.0,170,13,6,174,15,6,0,-2,0,2020-05-26
2020-05-26 09:35:00,2020-05-27 09:35:00,24.0,170,13,6,174,15,6,0,-2,0,2020-05-26
2020-05-26 09:45:00,2020-05-27 09:45:00,24.0,170,13,6,174,15,6,0,-2,0,2020-05-26
2020-05-26 09:45:00,2020-05-27 09:45:00,24.0,170,13,6,174,15,6,0,-2,0,2020-05-26
2020-05-26 10:15:00,2020-05-27 10:15:00,24.0,170,13,2,174,15,2,0,-2,0,2020-05-26
2020-05-26 10:20:00,2020-05-27 10:20:00,24.0,170,13,2,174,15,2,0,-2,0,2020-05-26
2020-05-26 11:45:00,2020-05-27 11:45:00,24.0,170,13,1,174,15,1,0,-2,0,2020-05-26
2020-05-27 08:15:00,2020-05-28 08:15:00,24.0,170,8,2,174,6,2,0,2,0,2020-05-27
2020-05-27 08:30:00,2020-05-28 08:30:00,24.0,170,8,2,174,6,2,0,2,0,2020-05-27
2020-05-27 09:25:00,2020-05-28 09:25:00,24.0,170,8,3,174,6,3,0,2,0,2020-05-27
2020-05-27 09:35:00,2020-05-28 09:35:00,24.0,170,8,3,174,6,3,0,2,0,2020-05-27
2020-05-27 09:45:00,2020-05-28 09:45:00,24.0,170,8,3,174,6,3,0,2,0,2020-05-27
2020-05-27 10:00:00,2020-05-27 14:00:00,4.0,170,8,1,174,15,1,0,-7,0,2020-05-27
2020-05-27 13:45:00,2020-05-28 13:45:00,24.0,170,8,1,174,6,1,0,2,0,2020-05-27
2020-05-27 16:00:00,2020-05-27 17:00:00,1.0,170,8,1,174,15,1,0,-7,0,2020-05-27
2020-05-28 08:40:00,2020-05-29 08:40:00,24.0,170,7,1,174,8,1,0,-1,0,2020-05-28
2020-05-28 09:30:00,2020-05-29 09:30:00,24.0,170,7,3,174,8,3,0,-1,0,2020-05-28
2020-05-28 09:30:00,2020-05-29 09:30:00,24.0,170,7,3,174,8,3,0,-1,0,2020-05-28
2020-05-28 09:40:00,2020-05-29 09:40:00,24.0,170,7,3,174,8,3,0,-1,0,2020-05-28
2020-05-28 10:05:00,2020-05-29 10:05:00,24.0,170,7,3,174,8,3,0,-1,0,2020-05-28
2020-05-28 10:10:00,2020-05-29 10:10:00,24.0,170,7,3,174,8,3,0,-1,0,2020-05-28
2020-05-28 10:15:00,2020-05-29 10:15:00,24.0,170,7,3,174,8,3,0,-1,0,2020-05-28
2020-05-29 08:00:00,2020-05-30 08:00:00,24.0,170,6,1,174,6,1,0,0,0,2020-05-29
2020-05-29 09:50:00,2020-05-30 09:50:00,24.0,170,6,2,174,6,2,0,0,0,2020-05-29
2020-05-29 09:55:00,2020-05-30 09:55:00,24.0,170,6,2,174,6,2,0,0,0,2020-05-29
2020-05-29 10:10:00,2020-05-30 10:10:00,24.0,170,6,3,174,6,3,0,0,0,2020-05-29
2020-05-29 10:30:00,2020-05-30 10:30:00,24.0,170,6,3,174,6,3,0,0,0,2020-05-29
2020-05-29 10:35:00,2020-05-30 10:35:00,24.0,170,6,3,174,6,3,0,0,0,2020-05-29
2020-05-30 10:05:00,2020-05-31 10:05:00,24.0,170,1,1,174,1,1,0,0,0,2020-05-30
2020-05-31 11:55:00,2020-06-01 11:55:00,24.0,170,1,1,213,2,1,0,-1,4,2020-05-31
2020-06-01 11:35:00,2020-06-02 11:35:00,24.0,225,4,1,213,4,1,0,0,0,2020-06-01
2020-06-01 19:15:00,2020-06-01 22:15:00,3.0,225,4,1,213,2,1,0,2,0,2020-06-01
2020-06-01 22:15:00,2020-06-02 00:15:00,2.0,225,4,2,213,4,2,0,0,0,2020-06-01
2020-06-01 22:15:00,2020-06-02 00:15:00,2.0,225,4,2,213,4,2,0,0,0,2020-06-01
2020-06-02 02:00:00,2020-07-02 02:00:00,720.0,225,9,1,275,17,1,0,-8,0,2020-06-02
2020-06-02 08:05:00,2020-06-03 08:05:00,24.0,225,9,2,213,8,2,0,1,0,2020-06-02
2020-06-02 08:30:00,2020-06-03 08:30:00,24.0,225,9,2,213,8,2,0,1,0,2020-06-02
2020-06-02 09:15:00,2020-06-03 09:15:00,24.0,225,9,3,213,8,3,0,1,0,2020-06-02
2020-06-02 09:25:00,2020-06-03 09:25:00,24.0,225,9,3,213,8,3,0,1,0,2020-06-02
2020-06-02 09:45:00,2020-06-03 09:45:00,24.0,225,9,3,213,8,3,0,1,0,2020-06-02
2020-06-02 10:00:00,2020-06-03 10:00:00,24.0,225,9,2,213,8,2,0,1,0,2020-06-02
2020-06-02 10:15:00,2020-06-03 10:15:00,24.0,225,9,2,213,8,2,0,1,0,2020-06-02
2020-06-02 15:10:00,2020-06-02 20:10:00,5.0,225,9,1,213,4,1,0,5,0,2020-06-02
2020-06-03 02:00:00,2020-07-03 02:00:00,720.0,225,12,1,275,12,1,0,0,0,2020-06-03
2020-06-03 08:30:00,2020-06-04 08:30:00,24.0,225,12,3,213,10,3,0,2,0,2020-06-03
2020-06-03 08:35:00,2020-06-04 08:35:00,24.0,225,12,3,213,10,3,0,2,0,2020-06-03
2020-06-03 08:55:00,2020-06-04 08:55:00,24.0,225,12,3,213,10,3,0,2,0,2020-06-03
2020-06-03 09:05:00,2020-06-04 09:05:00,24.0,225,12,6,213,10,5,1,2,0,2020-06-03
2020-06-03 09:25:00,2020-06-04 09:25:00,24.0,225,12,6,213,10,5,1,2,0,2020-06-03
2020-06-03 09:35:00,2020-06-04 09:35:00,24.0,225,12,6,213,10,5,1,2,0,2020-06-03
2020-06-03 09:35:00,2020-06-04 09:35:00,24.0,225,12,6,213,10,5,1,2,0,2020-06-03
2020-06-03 09:50:00,2020-06-03 14:50:00,5.0,225,12,6,213,8,1,5,4,0,2020-06-03
2020-06-03 09:55:00,2020-06-04 09:55:00,24.0,225,12,6,213,10,5,1,2,0,2020-06-03
2020-06-03 10:25:00,2020-06-04 10:25:00,24.0,225,12,1,213,10,1,0,2,0,2020-06-03
2020-06-03 13:25:00,2020-06-04 13:25:00,24.0,225,12,1,213,10,1,0,2,0,2020-06-03
2020-06-04 08:00:00,2020-06-05 08:00:00,24.0,225,12,2,213,12,2,0,0,0,2020-06-04
2020-06-04 08:25:00,2020-06-05 08:25:00,24.0,225,12,2,213,12,2,0,0,0,2020-06-04
2020-06-04 09:20:00,2020-06-05 09:20:00,24.0,225,12,6,213,12,6,0,0,0,2020-06-04
2020-06-04 09:25:00,2020-06-05 09:25:00,24.0,225,12,6,213,12,6,0,0,0,2020-06-04
2020-06-04 09:30:00,2020-06-05 09:30:00,24.0,225,12,6,213,12,6,0,0,0,2020-06-04
2020-06-04 09:40:00,2020-06-05 09:40:00,24.0,225,12,6,213,12,6,0,0,0,2020-06-04
2020-06-04 09:45:00,2020-06-05 09:45:00,24.0,225,12,6,213,12,6,0,0,0,2020-06-04
2020-06-04 09:50:00,2020-06-05 09:50:00,24.0,225,12,6,213,12,6,0,0,0,2020-06-04
2020-06-04 10:10:00,2020-06-05 10:10:00,24.0,225,12,2,213,12,2,0,0,0,2020-06-04
2020-06-04 10:15:00,2020-06-05 10:15:00,24.0,225,12,2,213,12,2,0,0,0,2020-06-04
2020-06-04 13:55:00,2020-06-05 13:55:00,24.0,225,12,1,213,12,1,0,0,0,2020-06-04
2020-06-04 23:50:00,2020-06-05 23:50:00,24.0,225,12,1,213,12,1,0,0,0,2020-06-04
2020-06-05 08:30:00,2020-06-06 08:30:00,24.0,225,8,1,213,8,1,0,0,0,2020-06-05
2020-06-05 09:25:00,2020-06-06 09:25:00,24.0,225,8,3,213,8,3,0,0,0,2020-06-05
2020-06-05 09:45:00,2020-06-06 09:45:00,24.0,225,8,3,213,8,3,0,0,0,2020-06-05
2020-06-05 09:50:00,2020-06-06 09:50:00,24.0,225,8,3,213,8,3,0,0,0,2020-06-05
2020-06-05 10:00:00,2020-06-06 10:00:00,24.0,225,8,3,213,8,3,0,0,0,2020-06-05
2020-06-05 10:00:00,2020-06-06 10:00:00,24.0,225,8,3,213,8,3,0,0,0,2020-06-05
2020-06-05 10:35:00,2020-06-06 10:35:00,24.0,225,8,3,213,8,3,0,0,0,2020-06-05
2020-06-05 11:25:00,2020-06-06 11:25:00,24.0,225,8,1,213,8,1,0,0,0,2020-06-05
2020-06-06 10:35:00,2020-06-07 10:35:00,24.0,225,2,1,213,3,1,0,-1,0,2020-06-06
2020-06-06 14:45:00,2020-06-07 12:45:00,22.0,225,2,1,213,3,1,0,-1,0,2020-06-06
2020-06-07 09:30:00,2020-06-08 09:30:00,24.0,225,3,1,213,3,1,0,0,0,2020-06-07
2020-06-07 11:00:00,2020-06-08 11:00:00,24.0,225,3,1,213,3,1,0,0,0,2020-06-07
2020-06-07 19:50:00,2020-06-07 21:50:00,2.0,225,3,1,213,3,1,0,0,0,2020-06-07
2020-06-08 08:05:00,2020-06-09 08:05:00,24.0,225,9,1,213,10,1,0,-1,0,2020-06-08
2020-06-08 09:05:00,2020-06-09 09:05:00,24.0,225,9,1,213,10,1,0,-1,0,2020-06-08
2020-06-08 10:05:00,2020-06-08 13:05:00,3.0,225,9,4,213,3,1,3,6,0,2020-06-08
2020-06-08 10:05:00,2020-06-09 10:05:00,24.0,225,9,4,213,10,3,1,-1,0,2020-06-08
2020-06-08 10:10:00,2020-06-09 10:10:00,24.0,225,9,4,213,10,3,1,-1,0,2020-06-08
2020-06-08 10:15:00,2020-06-09 10:15:00,24.0,225,9,4,213,10,3,1,-1,0,2020-06-08
2020-06-08 11:10:00,2020-06-09 11:10:00,24.0,225,9,1,213,10,1,0,-1,0,2020-06-08
2020-06-08 12:45:00,2020-06-09 12:45:00,24.0,225,9,1,213,10,1,0,-1,0,2020-06-08
2020-06-08 14:40:00,2020-06-09 14:40:00,24.0,225,9,1,213,10,1,0,-1,0,2020-06-08
2020-06-09 08:10:00,2020-06-10 08:10:00,24.0,225,14,3,213,12,2,1,2,0,2020-06-09
2020-06-09 08:30:00,2020-06-09 21:30:00,13.0,225,14,3,213,10,1,2,4,0,2020-06-09
2020-06-09 08:35:00,2020-06-10 08:35:00,24.0,225,14,3,213,12,2,1,2,0,2020-06-09
2020-06-09 09:00:00,2020-06-10 09:00:00,24.0,225,14,6,213,12,5,1,2,0,2020-06-09
2020-06-09 09:05:00,2020-06-09 18:05:00,9.0,225,14,6,213,10,1,5,4,0,2020-06-09
2020-06-09 09:25:00,2020-06-10 09:25:00,24.0,225,14,6,213,12,5,1,2,0,2020-06-09
2020-06-09 09:25:00,2020-06-10 09:25:00,24.0,225,14,6,213,12,5,1,2,0,2020-06-09
2020-06-09 09:30:00,2020-06-10 09:30:00,24.0,225,14,6,213,12,5,1,2,0,2020-06-09
2020-06-09 09:35:00,2020-06-10 09:35:00,24.0,225,14,6,213,12,5,1,2,0,2020-06-09
2020-06-09 10:00:00,2020-06-10 10:00:00,24.0,225,14,4,213,12,4,0,2,0,2020-06-09
2020-06-09 10:00:00,2020-06-10 10:00:00,24.0,225,14,4,213,12,4,0,2,0,2020-06-09
2020-06-09 10:10:00,2020-06-10 10:10:00,24.0,225,14,4,213,12,4,0,2,0,2020-06-09
2020-06-09 10:15:00,2020-06-10 10:15:00,24.0,225,14,4,213,12,4,0,2,0,2020-06-09
2020-06-09 15:05:00,2020-06-10 15:05:00,24.0,225,14,1,213,12,1,0,2,0,2020-06-09
2020-06-10 08:35:00,2020-06-11 08:35:00,24.0,225,14,1,213,14,1,0,0,0,2020-06-10
2020-06-10 09:35:00,2020-06-11 09:35:00,24.0,225,14,2,213,14,2,0,0,0,2020-06-10
2020-06-10 09:55:00,2020-06-11 09:55:00,24.0,225,14,2,213,14,2,0,0,0,2020-06-10
2020-06-10 10:00:00,2020-06-11 10:00:00,24.0,225,14,7,213,14,7,0,0,0,2020-06-10
2020-06-10 10:05:00,2020-06-11 10:05:00,24.0,225,14,7,213,14,7,0,0,0,2020-06-10
2020-06-10 10:10:00,2020-06-11 10:10:00,24.0,225,14,7,213,14,7,0,0,0,2020-06-10
2020-06-10 10:10:00,2020-06-11 10:10:00,24.0,225,14,7,213,14,7,0,0,0,2020-06-10
2020-06-10 10:15:00,2020-06-11 10:15:00,24.0,225,14,7,213,14,7,0,0,0,2020-06-10
2020-06-10 10:25:00,2020-06-11 10:25:00,24.0,225,14,7,213,14,7,0,0,0,2020-06-10
2020-06-10 10:30:00,2020-06-11 10:30:00,24.0,225,14,7,213,14,7,0,0,0,2020-06-10
2020-06-10 15:00:00,2020-06-11 15:00:00,24.0,225,14,1,213,14,1,0,0,0,2020-06-10
2020-06-10 17:25:00,2020-06-16 17:25:00,144.0,225,14,1,213,13,1,0,1,0,2020-06-10
2020-06-10 18:55:00,2020-06-11 18:55:00,24.0,225,14,1,213,14,1,0,0,0,2020-06-10
2020-06-10 22:30:00,2020-06-11 22:30:00,24.0,225,14,1,213,14,1,0,0,0,2020-06-10
2020-06-11 08:00:00,2020-06-12 08:00:00,24.0,225,12,3,213,13,3,0,-1,0,2020-06-11
2020-06-11 08:20:00,2020-06-12 08:20:00,24.0,225,12,3,213,13,3,0,-1,0,2020-06-11
2020-06-11 08:45:00,2020-06-12 08:45:00,24.0,225,12,3,213,13,3,0,-1,0,2020-06-11
2020-06-11 09:10:00,2020-06-12 09:10:00,24.0,225,12,6,213,13,6,0,-1,0,2020-06-11
2020-06-11 09:15:00,2020-06-12 09:15:00,24.0,225,12,6,213,13,6,0,-1,0,2020-06-11
2020-06-11 09:30:00,2020-06-12 09:30:00,24.0,225,12,6,213,13,6,0,-1,0,2020-06-11
2020-06-11 09:35:00,2020-06-12 09:35:00,24.0,225,12,6,213,13,6,0,-1,0,2020-06-11
2020-06-11 09:35:00,2020-06-12 09:35:00,24.0,225,12,6,213,13,6,0,-1,0,2020-06-11
2020-06-11 09:45:00,2020-06-12 09:45:00,24.0,225,12,6,213,13,6,0,-1,0,2020-06-11
2020-06-11 10:10:00,2020-06-12 10:10:00,24.0,225,12,2,213,13,2,0,-1,0,2020-06-11
2020-06-11 10:20:00,2020-06-12 10:20:00,24.0,225,12,2,213,13,2,0,-1,0,2020-06-11
2020-06-11 19:05:00,2020-06-12 19:05:00,24.0,225,12,1,213,13,1,0,-1,0,2020-06-11
2020-06-12 08:30:00,2020-06-13 08:30:00,24.0,225,10,1,213,9,1,0,1,variiert,2020-06-12
2020-06-12 09:00:00,2020-06-13 09:00:00,24.0,225,10,4,213,9,4,0,1,variiert,2020-06-12
2020-06-12 09:20:00,2020-06-13 09:20:00,24.0,225,10,4,213,9,4,0,1,variiert,2020-06-12
2020-06-12 09:20:00,2020-06-13 09:20:00,24.0,225,10,4,213,9,4,0,1,variiert,2020-06-12
2020-06-12 09:30:00,2020-06-13 09:30:00,24.0,225,10,4,213,9,4,0,1,variiert,2020-06-12
2020-06-12 10:30:00,2020-06-13 10:30:00,24.0,225,10,2,213,9,2,0,1,variiert,2020-06-12
2020-06-12 10:30:00,2020-06-13 10:30:00,24.0,225,10,2,213,9,2,0,1,variiert,2020-06-12
2020-06-12 11:25:00,2020-06-13 11:25:00,24.0,225,10,1,213,9,1,0,1,variiert,2020-06-12
2020-06-12 13:00:00,2020-06-12 23:00:00,10.0,225,10,2,213,13,1,1,-3,variiert,2020-06-12
2020-06-12 13:45:00,2020-06-13 13:45:00,24.0,225,10,2,213,9,1,1,1,variiert,2020-06-12
2020-06-13 09:20:00,2020-06-14 09:20:00,24.0,225,2,1,213,2,1,0,0,0,2020-06-13
2020-06-13 19:20:00,2020-06-14 19:20:00,24.0,225,2,1,213,2,1,0,0,0,2020-06-13
2020-06-15 08:20:00,2020-06-16 08:20:00,24.0,225,13,5,213,13,5,0,0,0,2020-06-15
2020-06-15 08:35:00,2020-06-16 08:35:00,24.0,225,13,5,213,13,5,0,0,0,2020-06-15
2020-06-15 08:45:00,2020-06-16 08:45:00,24.0,225,13,5,213,13,5,0,0,0,2020-06-15
2020-06-15 08:45:00,2020-06-16 08:45:00,24.0,225,13,5,213,13,5,0,0,0,2020-06-15
2020-06-15 08:50:00,2020-06-16 08:50:00,24.0,225,13,5,213,13,5,0,0,0,2020-06-15
2020-06-15 09:25:00,2020-06-16 09:25:00,24.0,225,13,4,213,13,4,0,0,0,2020-06-15
2020-06-15 09:30:00,2020-06-16 09:30:00,24.0,225,13,4,213,13,4,0,0,0,2020-06-15
2020-06-15 09:35:00,2020-06-16 09:35:00,24.0,225,13,4,213,13,4,0,0,0,2020-06-15
2020-06-15 09:55:00,2020-06-16 09:55:00,24.0,225,13,4,213,13,4,0,0,0,2020-06-15
2020-06-15 10:00:00,2020-06-16 10:00:00,24.0,225,13,3,213,13,3,0,0,0,2020-06-15
2020-06-15 10:15:00,2020-06-16 10:15:00,24.0,225,13,3,213,13,3,0,0,0,2020-06-15
2020-06-15 10:35:00,2020-06-16 10:35:00,24.0,225,13,3,213,13,3,0,0,0,2020-06-15
2020-06-15 14:25:00,2020-06-15 19:25:00,5.0,225,13,1,213,1,1,0,12,0,2020-06-15
2020-06-16 08:20:00,2020-06-17 08:20:00,24.0,225,11,4,213,12,4,0,-1,0,2020-06-16
2020-06-16 08:35:00,2020-06-17 08:35:00,24.0,225,11,4,213,12,4,0,-1,0,2020-06-16
2020-06-16 08:50:00,2020-06-17 08:50:00,24.0,225,11,4,213,12,4,0,-1,0,2020-06-16
2020-06-16 08:50:00,2020-06-17 08:50:00,24.0,225,11,4,213,12,4,0,-1,0,2020-06-16
2020-06-16 09:20:00,2020-06-17 09:20:00,24.0,225,11,4,213,12,4,0,-1,0,2020-06-16
2020-06-16 09:25:00,2020-06-17 09:25:00,24.0,225,11,4,213,12,4,0,-1,0,2020-06-16
2020-06-16 09:50:00,2020-06-17 09:50:00,24.0,225,11,4,213,12,4,0,-1,0,2020-06-16
2020-06-16 09:55:00,2020-06-17 09:55:00,24.0,225,11,4,213,12,4,0,-1,0,2020-06-16
2020-06-16 10:00:00,2020-06-17 10:00:00,24.0,225,11,2,213,12,2,0,-1,0,2020-06-16
2020-06-16 10:10:00,2020-06-17 10:10:00,24.0,225,11,2,213,12,2,0,-1,0,2020-06-16
2020-06-16 19:20:00,2020-06-17 19:20:00,24.0,225,11,1,213,12,1,0,-1,0,2020-06-16
2020-06-17 08:20:00,2020-06-18 08:20:00,24.0,225,13,4,213,12,4,0,1,0,2020-06-17
2020-06-17 08:30:00,2020-06-18 08:30:00,24.0,225,13,4,213,12,4,0,1,0,2020-06-17
2020-06-17 08:35:00,2020-06-18 08:35:00,24.0,225,13,4,213,12,4,0,1,0,2020-06-17
2020-06-17 08:50:00,2020-06-18 08:50:00,24.0,225,13,4,213,12,4,0,1,0,2020-06-17
2020-06-17 09:20:00,2020-06-18 09:20:00,24.0,225,13,5,213,12,5,0,1,0,2020-06-17
2020-06-17 09:25:00,2020-06-18 09:25:00,24.0,225,13,5,213,12,5,0,1,0,2020-06-17
2020-06-17 09:40:00,2020-06-18 09:40:00,24.0,225,13,5,213,12,5,0,1,0,2020-06-17
2020-06-17 09:40:00,2020-06-18 09:40:00,24.0,225,13,5,213,12,5,0,1,0,2020-06-17
2020-06-17 09:55:00,2020-06-18 09:55:00,24.0,225,13,5,213,12,5,0,1,0,2020-06-17
2020-06-17 10:05:00,2020-06-18 10:05:00,24.0,225,13,3,213,12,2,1,1,0,2020-06-17
2020-06-17 10:15:00,2020-06-18 10:15:00,24.0,225,13,3,213,12,2,1,1,0,2020-06-17
2020-06-17 10:40:00,2020-06-17 21:40:00,11.0,225,13,3,213,12,1,2,1,0,2020-06-17
2020-06-17 14:50:00,2020-06-18 14:50:00,24.0,225,13,1,213,12,1,0,1,0,2020-06-17
2020-06-18 08:15:00,2020-06-19 08:15:00,24.0,225,6,3,213,6,3,0,0,0,2020-06-18
2020-06-18 08:50:00,2020-06-19 08:50:00,24.0,225,6,3,213,6,3,0,0,0,2020-06-18
2020-06-18 08:50:00,2020-06-19 08:50:00,24.0,225,6,3,213,6,3,0,0,0,2020-06-18
2020-06-18 09:15:00,2020-06-19 09:15:00,24.0,225,6,3,213,6,3,0,0,0,2020-06-18
2020-06-18 09:30:00,2020-06-19 09:30:00,24.0,225,6,3,213,6,3,0,0,0,2020-06-18
2020-06-18 09:50:00,2020-06-19 09:50:00,24.0,225,6,3,213,6,3,0,0,0,2020-06-18
2020-06-19 08:20:00,2020-06-20 08:20:00,24.0,225,7,2,213,7,2,0,0,0,2020-06-19
2020-06-19 08:50:00,2020-06-20 08:50:00,24.0,225,7,2,213,7,2,0,0,0,2020-06-19
2020-06-19 09:25:00,2020-06-20 09:25:00,24.0,225,7,3,213,7,3,0,0,0,2020-06-19
2020-06-19 09:35:00,2020-06-20 09:35:00,24.0,225,7,3,213,7,3,0,0,0,2020-06-19
2020-06-19 09:45:00,2020-06-20 09:45:00,24.0,225,7,3,213,7,3,0,0,0,2020-06-19
2020-06-19 10:00:00,2020-06-20 10:00:00,24.0,225,7,2,213,7,2,0,0,0,2020-06-19
2020-06-19 10:25:00,2020-06-20 10:25:00,24.0,225,7,2,213,7,2,0,0,0,2020-06-19
2020-06-22 08:15:00,2020-06-23 08:15:00,24.0,225,7,2,213,6,2,0,1,0,2020-06-22
2020-06-22 08:55:00,2020-06-23 08:55:00,24.0,225,7,2,213,6,2,0,1,0,2020-06-22
2020-06-22 09:05:00,2020-06-23 09:05:00,24.0,225,7,2,213,6,2,0,1,0,2020-06-22
2020-06-22 09:30:00,2020-06-23 09:30:00,24.0,225,7,2,213,6,2,0,1,0,2020-06-22
2020-06-22 10:10:00,2020-06-26 19:10:00,105.0,225,7,3,213,11,1,2,-4,0,2020-06-22
2020-06-22 10:15:00,2020-06-23 10:15:00,24.0,225,7,3,213,6,2,1,1,0,2020-06-22
2020-06-22 10:45:00,2020-06-23 10:45:00,24.0,225,7,3,213,6,2,1,1,0,2020-06-22
2020-06-23 02:00:00,2020-07-23 02:00:00,720.0,225,7,1,275,15,1,0,-8,0,2020-06-23
2020-06-23 08:00:00,2020-06-24 08:00:00,24.0,225,7,4,213,7,4,0,0,0,2020-06-23
2020-06-23 08:15:00,2020-06-24 08:15:00,24.0,225,7,4,213,7,4,0,0,0,2020-06-23
2020-06-23 08:30:00,2020-06-24 08:30:00,24.0,225,7,4,213,7,4,0,0,0,2020-06-23
2020-06-23 08:30:00,2020-06-24 08:30:00,24.0,225,7,4,213,7,4,0,0,0,2020-06-23
2020-06-23 09:25:00,2020-06-24 09:25:00,24.0,225,7,1,213,7,1,0,0,0,2020-06-23
2020-06-23 10:00:00,2020-06-24 10:00:00,24.0,225,7,1,213,7,1,0,0,0,2020-06-23
2020-06-24 08:10:00,2020-06-25 08:10:00,24.0,225,7,2,213,6,2,0,1,0,2020-06-24
2020-06-24 08:55:00,2020-06-25 08:55:00,24.0,225,7,2,213,6,2,0,1,0,2020-06-24
2020-06-24 10:20:00,2020-06-25 10:20:00,24.0,225,7,2,213,6,2,0,1,0,2020-06-24
2020-06-24 10:35:00,2020-06-25 10:35:00,24.0,225,7,2,213,6,2,0,1,0,2020-06-24
2020-06-24 11:20:00,2020-06-25 11:20:00,24.0,225,7,1,213,6,1,0,1,0,2020-06-24
2020-06-24 14:10:00,2020-06-26 18:10:00,52.0,225,7,2,213,11,1,1,-4,0,2020-06-24
2020-06-24 14:50:00,2020-06-24 15:50:00,1.0,225,7,2,213,7,1,1,0,0,2020-06-24
2020-06-25 08:10:00,2020-06-26 08:10:00,24.0,225,9,5,213,11,4,1,-2,0,2020-06-25
2020-06-25 08:20:00,2020-06-25 19:20:00,11.0,225,9,5,213,6,1,4,3,0,2020-06-25
2020-06-25 08:25:00,2020-06-26 08:25:00,24.0,225,9,5,213,11,4,1,-2,0,2020-06-25
2020-06-25 08:35:00,2020-06-26 08:35:00,24.0,225,9,5,213,11,4,1,-2,0,2020-06-25
2020-06-25 08:40:00,2020-06-26 08:40:00,24.0,225,9,5,213,11,4,1,-2,0,2020-06-25
2020-06-25 09:45:00,2020-06-26 09:45:00,24.0,225,9,2,213,11,2,0,-2,0,2020-06-25
2020-06-25 09:45:00,2020-06-26 09:45:00,24.0,225,9,2,213,11,2,0,-2,0,2020-06-25
2020-06-25 10:35:00,2020-06-26 10:35:00,24.0,225,9,1,213,11,1,0,-2,0,2020-06-25
2020-06-25 17:30:00,2020-06-26 17:30:00,24.0,225,9,1,213,11,1,0,-2,0,2020-06-25
2020-06-26 08:00:00,2020-06-27 08:00:00,24.0,225,11,5,213,9,5,0,2,0,2020-06-26
2020-06-26 08:05:00,2020-06-27 08:05:00,24.0,225,11,5,213,9,5,0,2,0,2020-06-26
2020-06-26 08:10:00,2020-06-27 08:10:00,24.0,225,11,5,213,9,5,0,2,0,2020-06-26
2020-06-26 08:55:00,2020-06-27 08:55:00,24.0,225,11,5,213,9,5,0,2,0,2020-06-26
2020-06-26 08:55:00,2020-06-27 08:55:00,24.0,225,11,5,213,9,5,0,2,0,2020-06-26
2020-06-26 09:55:00,2020-06-27 09:55:00,24.0,225,11,2,213,9,2,0,2,0,2020-06-26
2020-06-26 09:55:00,2020-06-27 09:55:00,24.0,225,11,2,213,9,2,0,2,0,2020-06-26
2020-06-26 10:35:00,2020-06-27 10:35:00,24.0,225,11,1,213,9,1,0,2,0,2020-06-26
2020-06-26 11:15:00,2020-06-27 11:15:00,24.0,225,11,1,213,9,1,0,2,0,2020-06-26
2020-06-26 17:40:00,2020-06-26 20:40:00,3.0,225,11,1,213,11,1,0,0,0,2020-06-26
2020-06-26 20:00:00,2020-06-29 20:00:00,72.0,225,11,1,213,3,1,0,8,0,2020-06-26
2020-06-27 11:10:00,2020-06-28 11:10:00,24.0,225,2,1,213,2,1,0,0,0,2020-06-27
2020-06-27 12:25:00,2020-06-28 12:25:00,24.0,225,2,1,213,2,1,0,0,0,2020-06-27
2020-06-28 02:30:00,2020-06-29 02:30:00,24.0,225,1,1,213,3,1,0,-2,0,2020-06-28
2020-06-29 08:15:00,2020-06-30 08:15:00,24.0,225,9,2,213,8,2,0,1,0,2020-06-29
2020-06-29 08:50:00,2020-06-30 08:50:00,24.0,225,9,2,213,8,2,0,1,0,2020-06-29
2020-06-29 09:00:00,2020-06-30 09:00:00,24.0,225,9,4,213,8,4,0,1,0,2020-06-29
2020-06-29 09:20:00,2020-06-30 09:20:00,24.0,225,9,4,213,8,4,0,1,0,2020-06-29
2020-06-29 09:35:00,2020-06-30 09:35:00,24.0,225,9,4,213,8,4,0,1,0,2020-06-29
2020-06-29 09:50:00,2020-06-30 09:50:00,24.0,225,9,4,213,8,4,0,1,0,2020-06-29
2020-06-29 10:30:00,2020-06-29 18:30:00,8.0,225,9,1,213,3,1,0,6,0,2020-06-29
2020-06-29 12:20:00,2020-06-30 12:20:00,24.0,225,9,1,213,8,1,0,1,0,2020-06-29
2020-06-29 15:00:00,2020-06-30 15:00:00,24.0,225,9,1,213,8,1,0,1,0,2020-06-29
2020-06-30 08:05:00,2020-07-01 08:05:00,24.0,225,11,4,275,11,4,0,0,0,2020-06-30
2020-06-30 08:35:00,2020-07-01 08:35:00,24.0,225,11,4,275,11,4,0,0,0,2020-06-30
2020-06-30 08:55:00,2020-07-01 08:55:00,24.0,225,11,4,275,11,4,0,0,0,2020-06-30
2020-06-30 08:55:00,2020-07-01 08:55:00,24.0,225,11,4,275,11,4,0,0,0,2020-06-30
2020-06-30 09:35:00,2020-07-01 09:35:00,24.0,225,11,4,275,11,4,0,0,0,2020-06-30
2020-06-30 09:35:00,2020-07-01 09:35:00,24.0,225,11,4,275,11,4,0,0,0,2020-06-30
2020-06-30 09:40:00,2020-07-01 09:40:00,24.0,225,11,4,275,11,4,0,0,0,2020-06-30
2020-06-30 09:50:00,2020-07-01 09:50:00,24.0,225,11,4,275,11,4,0,0,0,2020-06-30
2020-06-30 10:00:00,2020-07-01 10:00:00,24.0,225,11,3,275,11,3,0,0,0,2020-06-30
2020-06-30 10:15:00,2020-07-01 10:15:00,24.0,225,11,3,275,11,3,0,0,0,2020-06-30
2020-06-30 10:40:00,2020-07-01 10:40:00,24.0,225,11,3,275,11,3,0,0,0,2020-06-30
2020-07-01 08:10:00,2020-07-02 08:10:00,24.0,273,15,3,275,17,3,0,-2,0,2020-07-01
2020-07-01 08:35:00,2020-07-02 08:35:00,24.0,273,15,3,275,17,3,0,-2,0,2020-07-01
2020-07-01 08:45:00,2020-07-02 08:45:00,24.0,273,15,3,275,17,3,0,-2,0,2020-07-01
2020-07-01 09:00:00,2020-07-02 09:00:00,24.0,273,15,4,275,17,4,0,-2,0,2020-07-01
2020-07-01 09:25:00,2020-07-02 09:25:00,24.0,273,15,4,275,17,4,0,-2,0,2020-07-01
2020-07-01 09:50:00,2020-07-02 09:50:00,24.0,273,15,4,275,17,4,0,-2,0,2020-07-01
2020-07-01 09:55:00,2020-07-02 09:55:00,24.0,273,15,4,275,17,4,0,-2,0,2020-07-01
2020-07-01 10:05:00,2020-07-02 10:05:00,24.0,273,15,5,275,17,5,0,-2,0,2020-07-01
2020-07-01 10:20:00,2020-07-02 10:20:00,24.0,273,15,5,275,17,5,0,-2,0,2020-07-01
2020-07-01 10:25:00,2020-07-02 10:25:00,24.0,273,15,5,275,17,5,0,-2,0,2020-07-01
2020-07-01 10:30:00,2020-07-02 10:30:00,24.0,273,15,5,275,17,5,0,-2,0,2020-07-01
2020-07-01 10:35:00,2020-07-02 10:35:00,24.0,273,15,5,275,17,5,0,-2,0,2020-07-01
2020-07-01 11:00:00,2020-07-02 11:00:00,24.0,273,15,1,275,17,1,0,-2,0,2020-07-01
2020-07-01 14:30:00,2020-07-02 14:30:00,24.0,273,15,1,275,17,2,-1,-2,0,2020-07-01
2020-07-01 19:35:00,2020-07-02 19:35:00,24.0,273,15,1,275,17,1,0,-2,0,2020-07-01
2020-07-02 02:00:00,2020-08-02 02:00:00,744.0,273,12,1,280,1,1,0,11,0,2020-07-02
2020-07-02 08:05:00,2020-07-03 08:05:00,24.0,273,12,3,275,12,3,0,0,0,2020-07-02
2020-07-02 08:10:00,2020-07-03 08:10:00,24.0,273,12,3,275,12,3,0,0,0,2020-07-02
2020-07-02 08:55:00,2020-07-03 08:55:00,24.0,273,12,3,275,12,3,0,0,0,2020-07-02
2020-07-02 09:20:00,2020-07-03 09:20:00,24.0,273,12,4,275,12,4,0,0,0,2020-07-02
2020-07-02 09:25:00,2020-07-03 09:25:00,24.0,273,12,4,275,12,4,0,0,0,2020-07-02
2020-07-02 09:35:00,2020-07-03 09:35:00,24.0,273,12,4,275,12,4,0,0,0,2020-07-02
2020-07-02 09:55:00,2020-07-03 09:55:00,24.0,273,12,4,275,12,4,0,0,0,2020-07-02
2020-07-02 10:00:00,2020-07-03 10:00:00,24.0,273,12,3,275,12,2,1,0,0,2020-07-02
2020-07-02 10:20:00,2020-07-03 10:20:00,24.0,273,12,3,275,12,2,1,0,0,2020-07-02
2020-07-02 10:25:00,2020-07-02 14:25:00,4.0,273,12,3,275,17,2,1,-5,0,2020-07-02
2020-07-02 20:05:00,2020-07-03 20:05:00,24.0,273,12,1,275,12,1,0,0,0,2020-07-02
2020-07-03 07:55:00,2020-07-04 07:55:00,24.0,273,14,1,275,13,1,0,1,0,2020-07-03
2020-07-03 08:15:00,2020-07-04 08:15:00,24.0,273,14,2,275,13,2,0,1,0,2020-07-03
2020-07-03 08:25:00,2020-07-04 08:25:00,24.0,273,14,2,275,13,2,0,1,0,2020-07-03
2020-07-03 09:00:00,2020-07-03 18:00:00,9.0,273,14,4,275,12,1,3,2,0,2020-07-03
2020-07-03 09:30:00,2020-07-04 09:30:00,24.0,273,14,4,275,13,3,1,1,0,2020-07-03
2020-07-03 09:30:00,2020-07-04 09:30:00,24.0,273,14,4,275,13,3,1,1,0,2020-07-03
2020-07-03 09:45:00,2020-07-04 09:45:00,24.0,273,14,4,275,13,3,1,1,0,2020-07-03
2020-07-03 10:00:00,2020-07-04 10:00:00,24.0,273,14,5,275,13,5,0,1,0,2020-07-03
2020-07-03 10:05:00,2020-07-04 10:05:00,24.0,273,14,5,275,13,5,0,1,0,2020-07-03
2020-07-03 10:20:00,2020-07-04 10:20:00,24.0,273,14,5,275,13,5,0,1,0,2020-07-03
2020-07-03 10:25:00,2020-07-04 10:25:00,24.0,273,14,5,275,13,5,0,1,0,2020-07-03
2020-07-03 10:30:00,2020-07-04 10:30:00,24.0,273,14,5,275,13,5,0,1,0,2020-07-03
2020-07-03 11:35:00,2020-07-04 11:35:00,24.0,273,14,1,275,13,1,0,1,0,2020-07-03
2020-07-03 19:40:00,2020-07-04 19:40:00,24.0,273,14,1,275,13,1,0,1,0,2020-07-03
2020-07-04 03:15:00,2020-07-05 03:15:00,24.0,273,2,1,275,2,1,0,0,0,2020-07-04
2020-07-04 09:10:00,2020-07-05 09:10:00,24.0,273,2,1,275,2,1,0,0,0,2020-07-04
2020-07-06 02:00:00,2020-08-06 02:00:00,744.0,273,8,1,280,16,1,0,-8,5,2020-07-06
2020-07-06 08:35:00,2020-07-07 08:35:00,24.0,273,8,2,275,6,2,0,2,5,2020-07-06
2020-07-06 08:35:00,2020-07-07 08:35:00,24.0,273,8,2,275,6,2,0,2,5,2020-07-06
2020-07-06 09:05:00,2020-07-07 09:05:00,24.0,273,8,3,275,6,2,1,2,5,2020-07-06
2020-07-06 09:05:00,2020-07-08 09:05:00,48.0,273,8,3,275,11,7,-4,-3,5,2020-07-06
2020-07-06 09:45:00,2020-07-07 09:45:00,24.0,273,8,3,275,6,2,1,2,5,2020-07-06
2020-07-06 10:10:00,2020-07-07 10:10:00,24.0,273,8,2,275,6,2,0,2,5,2020-07-06
2020-07-06 10:40:00,2020-07-07 10:40:00,24.0,273,8,2,275,6,2,0,2,5,2020-07-06
2020-07-07 08:20:00,2020-07-08 08:20:00,24.0,273,10,3,275,11,3,0,-1,0,2020-07-07
2020-07-07 08:35:00,2020-07-08 08:35:00,24.0,273,10,3,275,11,3,0,-1,0,2020-07-07
2020-07-07 08:55:00,2020-07-08 08:55:00,24.0,273,10,3,275,11,3,0,-1,0,2020-07-07
2020-07-07 09:00:00,2020-07-08 09:00:00,24.0,273,10,5,275,11,7,-2,-1,0,2020-07-07
2020-07-07 09:05:00,2020-07-08 09:05:00,24.0,273,10,5,275,11,7,-2,-1,0,2020-07-07
2020-07-07 09:30:00,2020-07-08 09:30:00,24.0,273,10,5,275,11,7,-2,-1,0,2020-07-07
2020-07-07 09:35:00,2020-07-08 09:35:00,24.0,273,10,5,275,11,7,-2,-1,0,2020-07-07
2020-07-07 09:50:00,2020-07-08 09:50:00,24.0,273,10,5,275,11,7,-2,-1,0,2020-07-07
2020-07-07 10:25:00,2020-07-08 10:25:00,24.0,273,10,1,275,11,1,0,-1,0,2020-07-07
2020-07-07 22:55:00,2020-07-08 09:55:00,11.0,273,10,1,275,11,7,-6,-1,0,2020-07-07
2020-07-08 02:00:00,2020-08-08 02:00:00,744.0,273,11,1,280,10,1,0,1,0,2020-07-08
2020-07-08 08:55:00,2020-07-09 08:55:00,24.0,273,11,1,275,10,1,0,1,0,2020-07-08
2020-07-08 09:00:00,2020-07-09 09:00:00,24.0,273,11,5,275,10,5,0,1,0,2020-07-08
2020-07-08 09:15:00,2020-07-09 09:15:00,24.0,273,11,5,275,10,5,0,1,0,2020-07-08
2020-07-08 09:30:00,2020-07-09 09:30:00,24.0,273,11,5,275,10,5,0,1,0,2020-07-08
2020-07-08 09:45:00,2020-07-09 09:45:00,24.0,273,11,5,275,10,5,0,1,0,2020-07-08
2020-07-08 09:50:00,2020-07-09 09:50:00,24.0,273,11,5,275,10,5,0,1,0,2020-07-08
2020-07-08 10:10:00,2020-07-09 10:10:00,24.0,273,11,3,275,10,3,0,1,0,2020-07-08
2020-07-08 10:35:00,2020-07-09 10:35:00,24.0,273,11,3,275,10,3,0,1,0,2020-07-08
2020-07-08 10:40:00,2020-07-09 10:40:00,24.0,273,11,3,275,10,3,0,1,0,2020-07-08
2020-07-08 20:40:00,2020-07-09 20:40:00,24.0,273,11,1,275,10,1,0,1,0,2020-07-08
2020-07-09 08:10:00,2020-07-10 08:10:00,24.0,273,9,2,275,10,2,0,-1,0,2020-07-09
2020-07-09 08:40:00,2020-07-10 08:40:00,24.0,273,9,2,275,10,2,0,-1,0,2020-07-09
2020-07-09 09:10:00,2020-07-10 09:10:00,24.0,273,9,3,275,10,3,0,-1,0,2020-07-09
2020-07-09 09:35:00,2020-07-10 09:35:00,24.0,273,9,3,275,10,3,0,-1,0,2020-07-09
2020-07-09 09:40:00,2020-07-10 09:40:00,24.0,273,9,3,275,10,3,0,-1,0,2020-07-09
2020-07-09 10:00:00,2020-07-10 10:00:00,24.0,273,9,3,275,10,3,0,-1,0,2020-07-09
2020-07-09 10:15:00,2020-07-10 10:15:00,24.0,273,9,3,275,10,3,0,-1,0,2020-07-09
2020-07-09 10:20:00,2020-07-10 10:20:00,24.0,273,9,3,275,10,3,0,-1,0,2020-07-09
2020-07-09 20:50:00,2020-07-10 20:50:00,24.0,273,9,1,275,10,1,0,-1,0,2020-07-09
2020-07-10 08:35:00,2020-07-11 08:35:00,24.0,273,10,3,275,9,3,0,1,0,2020-07-10
2020-07-10 08:55:00,2020-07-11 08:55:00,24.0,273,10,3,275,9,3,0,1,0,2020-07-10
2020-07-10 08:55:00,2020-07-11 08:55:00,24.0,273,10,3,275,9,3,0,1,0,2020-07-10
2020-07-10 09:40:00,2020-07-11 09:40:00,24.0,273,10,1,275,9,1,0,1,0,2020-07-10
2020-07-10 10:00:00,2020-07-10 23:00:00,13.0,273,10,2,275,10,1,1,0,0,2020-07-10
2020-07-10 10:35:00,2020-07-11 10:35:00,24.0,273,10,2,275,9,1,1,1,0,2020-07-10
2020-07-10 14:25:00,2020-07-11 14:25:00,24.0,273,10,1,275,9,1,0,1,0,2020-07-10
2020-07-10 19:40:00,2020-07-11 19:40:00,24.0,273,10,1,275,9,1,0,1,0,2020-07-10
2020-07-10 20:50:00,2020-07-11 20:50:00,24.0,273,10,1,275,9,1,0,1,0,2020-07-10
2020-07-10 21:05:00,2020-07-11 21:05:00,24.0,273,10,1,275,9,1,0,1,0,2020-07-10
2020-07-11 09:15:00,2020-07-12 09:15:00,24.0,273,3,1,275,3,1,0,0,0,2020-07-11
2020-07-11 20:55:00,2020-07-12 20:55:00,24.0,273,3,1,275,3,1,0,0,0,2020-07-11
2020-07-11 22:55:00,2020-07-12 22:55:00,24.0,273,3,1,275,3,1,0,0,0,2020-07-11
2020-07-12 22:55:00,2020-07-13 22:55:00,24.0,273,1,1,275,1,1,0,0,0,2020-07-12
2020-07-13 09:00:00,2020-07-14 09:00:00,24.0,273,8,4,275,8,3,1,0,0,2020-07-13
2020-07-13 09:00:00,2020-07-15 02:00:00,41.0,273,8,4,275,12,1,3,-4,0,2020-07-13
2020-07-13 09:45:00,2020-07-14 09:45:00,24.0,273,8,4,275,8,3,1,0,0,2020-07-13
2020-07-13 09:50:00,2020-07-14 09:50:00,24.0,273,8,4,275,8,3,1,0,0,2020-07-13
2020-07-13 10:00:00,2020-07-14 10:00:00,24.0,273,8,4,275,8,4,0,0,0,2020-07-13
2020-07-13 10:10:00,2020-07-14 10:10:00,24.0,273,8,4,275,8,4,0,0,0,2020-07-13
2020-07-13 10:10:00,2020-07-14 10:10:00,24.0,273,8,4,275,8,4,0,0,0,2020-07-13
2020-07-13 10:10:00,2020-07-14 10:10:00,24.0,273,8,4,275,8,4,0,0,0,2020-07-13
2020-07-14 08:15:00,2020-07-15 08:15:00,24.0,273,10,2,275,12,2,0,-2,0,2020-07-14
2020-07-14 08:40:00,2020-07-15 08:40:00,24.0,273,10,2,275,12,2,0,-2,0,2020-07-14
2020-07-14 09:25:00,2020-07-15 09:25:00,24.0,273,10,5,275,12,5,0,-2,0,2020-07-14
2020-07-14 09:30:00,2020-07-15 09:30:00,24.0,273,10,5,275,12,5,0,-2,0,2020-07-14
2020-07-14 09:35:00,2020-07-15 09:35:00,24.0,273,10,5,275,12,5,0,-2,0,2020-07-14
2020-07-14 09:45:00,2020-07-15 09:45:00,24.0,273,10,5,275,12,5,0,-2,0,2020-07-14
2020-07-14 09:55:00,2020-07-15 09:55:00,24.0,273,10,5,275,12,5,0,-2,0,2020-07-14
2020-07-14 10:05:00,2020-07-15 10:05:00,24.0,273,10,1,275,12,1,0,-2,0,2020-07-14
2020-07-14 16:15:00,2020-07-15 16:15:00,24.0,273,10,1,275,12,1,0,-2,0,2020-07-14
2020-07-14 18:10:00,2020-07-14 20:10:00,2.0,273,10,1,275,8,1,0,2,0,2020-07-14
2020-07-15 08:25:00,2020-07-16 08:25:00,24.0,273,15,2,275,13,2,0,2,0,2020-07-15
2020-07-15 08:35:00,2020-07-16 08:35:00,24.0,273,15,2,275,13,2,0,2,0,2020-07-15
2020-07-15 09:00:00,2020-07-16 09:00:00,24.0,273,15,7,275,13,6,1,2,0,2020-07-15
2020-07-15 09:00:00,2020-07-15 18:00:00,9.0,273,15,7,275,12,1,6,3,0,2020-07-15
2020-07-15 09:10:00,2020-07-16 09:10:00,24.0,273,15,7,275,13,6,1,2,0,2020-07-15
2020-07-15 09:10:00,2020-07-16 09:10:00,24.0,273,15,7,275,13,6,1,2,0,2020-07-15
2020-07-15 09:40:00,2020-07-16 09:40:00,24.0,273,15,7,275,13,6,1,2,0,2020-07-15
2020-07-15 09:45:00,2020-07-16 09:45:00,24.0,273,15,7,275,13,6,1,2,0,2020-07-15
2020-07-15 09:50:00,2020-07-16 09:50:00,24.0,273,15,7,275,13,6,1,2,0,2020-07-15
2020-07-15 10:05:00,2020-07-16 10:05:00,24.0,273,15,3,275,13,2,1,2,0,2020-07-15
2020-07-15 10:10:00,2020-07-15 14:10:00,4.0,273,15,3,275,12,1,2,3,0,2020-07-15
2020-07-15 10:40:00,2020-07-16 10:40:00,24.0,273,15,3,275,13,2,1,2,0,2020-07-15
2020-07-15 15:20:00,2020-07-16 15:20:00,24.0,273,15,1,275,13,1,0,2,0,2020-07-15
2020-07-15 18:45:00,2020-07-17 18:45:00,48.0,273,15,1,275,9,2,-1,6,0,2020-07-15
2020-07-15 23:00:00,2020-07-16 23:00:00,24.0,273,15,1,275,13,1,0,2,0,2020-07-15
2020-07-16 08:10:00,2020-07-17 08:10:00,24.0,273,7,2,275,9,2,0,-2,0,2020-07-16
2020-07-16 08:15:00,2020-07-17 08:15:00,24.0,273,7,2,275,9,2,0,-2,0,2020-07-16
2020-07-16 09:35:00,2020-07-17 09:35:00,24.0,273,7,3,275,9,3,0,-2,0,2020-07-16
2020-07-16 09:40:00,2020-07-17 09:40:00,24.0,273,7,3,275,9,3,0,-2,0,2020-07-16
2020-07-16 09:45:00,2020-07-17 09:45:00,24.0,273,7,3,275,9,3,0,-2,0,2020-07-16
2020-07-16 10:20:00,2020-07-17 10:20:00,24.0,273,7,1,275,9,1,0,-2,0,2020-07-16
2020-07-16 16:10:00,2020-07-16 20:10:00,4.0,273,7,1,275,13,1,0,-6,0,2020-07-16
2020-07-17 08:20:00,2020-07-18 08:20:00,24.0,273,12,2,275,9,2,0,3,0,2020-07-17
2020-07-17 08:50:00,2020-07-18 08:50:00,24.0,273,12,2,275,9,2,0,3,0,2020-07-17
2020-07-17 09:00:00,2020-07-18 09:00:00,24.0,273,12,3,275,9,3,0,3,0,2020-07-17
2020-07-17 09:10:00,2020-07-18 09:10:00,24.0,273,12,3,275,9,3,0,3,0,2020-07-17
2020-07-17 09:55:00,2020-07-18 09:55:00,24.0,273,12,3,275,9,3,0,3,0,2020-07-17
2020-07-17 10:00:00,2020-07-18 10:00:00,24.0,273,12,3,275,9,3,0,3,0,2020-07-17
2020-07-17 10:15:00,2020-07-18 10:15:00,24.0,273,12,3,275,9,3,0,3,0,2020-07-17
2020-07-17 10:35:00,2020-07-18 10:35:00,24.0,273,12,3,275,9,3,0,3,0,2020-07-17
2020-07-17 11:50:00,2020-07-17 18:50:00,7.0,273,12,1,275,9,2,-1,3,0,2020-07-17
2020-07-17 19:25:00,2020-07-19 19:25:00,48.0,273,12,2,275,3,1,1,9,0,2020-07-17
2020-07-17 19:35:00,2020-07-17 20:35:00,1.0,273,12,2,275,9,1,1,3,0,2020-07-17
2020-07-17 20:00:00,2020-07-18 20:00:00,24.0,273,12,1,275,9,1,0,3,0,2020-07-17
2020-07-18 01:10:00,2020-07-19 01:10:00,24.0,273,2,1,275,3,1,0,-1,0,2020-07-18
2020-07-18 10:00:00,2020-07-19 10:00:00,24.0,273,2,1,275,3,1,0,-1,0,2020-07-18
2020-07-19 02:00:00,2020-07-20 02:00:00,24.0,273,2,1,275,2,1,0,0,0,2020-07-19
2020-07-19 22:15:00,2020-07-21 22:15:00,48.0,273,2,1,275,9,1,0,-7,0,2020-07-19
2020-07-20 08:15:00,2020-07-21 08:15:00,24.0,273,9,3,275,9,3,0,0,0,2020-07-20
2020-07-20 08:25:00,2020-07-21 08:25:00,24.0,273,9,3,275,9,3,0,0,0,2020-07-20
2020-07-20 08:35:00,2020-07-21 08:35:00,24.0,273,9,3,275,9,3,0,0,0,2020-07-20
2020-07-20 09:00:00,2020-07-20 20:00:00,11.0,273,9,4,275,2,1,3,7,0,2020-07-20
2020-07-20 09:00:00,2020-07-22 09:00:00,48.0,273,9,4,275,12,5,-1,-3,0,2020-07-20
2020-07-20 09:15:00,2020-07-21 09:15:00,24.0,273,9,4,275,9,2,2,0,0,2020-07-20
2020-07-20 09:35:00,2020-07-21 09:35:00,24.0,273,9,4,275,9,2,2,0,0,2020-07-20
2020-07-20 10:05:00,2020-07-21 10:05:00,24.0,273,9,2,275,9,2,0,0,0,2020-07-20
2020-07-20 10:50:00,2020-07-21 10:50:00,24.0,273,9,2,275,9,2,0,0,0,2020-07-20
2020-07-21 08:15:00,2020-07-22 08:15:00,24.0,273,10,3,275,12,3,0,-2,0,2020-07-21
2020-07-21 08:25:00,2020-07-22 08:25:00,24.0,273,10,3,275,12,3,0,-2,0,2020-07-21
2020-07-21 08:50:00,2020-07-22 08:50:00,24.0,273,10,3,275,12,3,0,-2,0,2020-07-21
2020-07-21 09:25:00,2020-07-22 09:25:00,24.0,273,10,4,275,12,5,-1,-2,0,2020-07-21
2020-07-21 09:30:00,2020-07-22 09:30:00,24.0,273,10,4,275,12,5,-1,-2,0,2020-07-21
2020-07-21 09:35:00,2020-07-22 09:35:00,24.0,273,10,4,275,12,5,-1,-2,0,2020-07-21
2020-07-21 09:45:00,2020-07-22 09:45:00,24.0,273,10,4,275,12,5,-1,-2,0,2020-07-21
2020-07-21 10:05:00,2020-07-22 10:05:00,24.0,273,10,2,275,12,2,0,-2,0,2020-07-21
2020-07-21 10:05:00,2020-07-22 10:05:00,24.0,273,10,2,275,12,2,0,-2,0,2020-07-21
2020-07-21 18:10:00,2020-07-21 19:10:00,1.0,273,10,1,275,9,1,0,1,0,2020-07-21
2020-07-22 00:10:00,2020-07-24 00:10:00,48.0,273,16,1,275,15,1,0,1,0,2020-07-22
2020-07-22 07:55:00,2020-07-23 07:55:00,24.0,273,16,1,275,15,1,0,1,0,2020-07-22
2020-07-22 08:15:00,2020-07-23 08:15:00,24.0,273,16,6,275,15,5,1,1,0,2020-07-22
2020-07-22 08:15:00,2020-07-23 08:15:00,24.0,273,16,6,275,15,5,1,1,0,2020-07-22
2020-07-22 08:25:00,2020-07-23 08:25:00,24.0,273,16,6,275,15,5,1,1,0,2020-07-22
2020-07-22 08:30:00,2020-07-23 08:30:00,24.0,273,16,6,275,15,5,1,1,0,2020-07-22
2020-07-22 08:55:00,2020-07-22 19:55:00,11.0,273,16,6,275,12,1,5,4,0,2020-07-22
2020-07-22 08:55:00,2020-07-23 08:55:00,24.0,273,16,6,275,15,5,1,1,0,2020-07-22
2020-07-22 09:05:00,2020-07-22 18:05:00,9.0,273,16,6,275,12,1,5,4,0,2020-07-22
2020-07-22 09:25:00,2020-07-23 09:25:00,24.0,273,16,6,275,15,5,1,1,0,2020-07-22
2020-07-22 09:40:00,2020-07-23 09:40:00,24.0,273,16,6,275,15,5,1,1,0,2020-07-22
2020-07-22 09:40:00,2020-07-23 09:40:00,24.0,273,16,6,275,15,5,1,1,0,2020-07-22
2020-07-22 09:45:00,2020-07-23 09:45:00,24.0,273,16,6,275,15,5,1,1,0,2020-07-22
2020-07-22 09:50:00,2020-07-23 09:50:00,24.0,273,16,6,275,15,5,1,1,0,2020-07-22
2020-07-22 10:20:00,2020-07-23 10:20:00,24.0,273,16,1,275,15,1,0,1,0,2020-07-22
2020-07-22 19:55:00,2020-07-23 19:55:00,24.0,273,16,1,275,15,1,0,1,0,2020-07-22
2020-07-23 01:55:00,2020-07-24 01:55:00,24.0,273,16,1,275,15,1,0,1,0,2020-07-23
2020-07-23 02:00:00,2020-08-23 02:00:00,744.0,273,16,1,280,3,1,0,13,0,2020-07-23
2020-07-23 08:00:00,2020-07-25 08:00:00,48.0,273,16,5,275,8,4,1,8,0,2020-07-23
2020-07-23 08:10:00,2020-07-24 08:10:00,24.0,273,16,5,275,15,4,1,1,0,2020-07-23
2020-07-23 08:15:00,2020-07-24 08:15:00,24.0,273,16,5,275,15,4,1,1,0,2020-07-23
2020-07-23 08:25:00,2020-07-24 08:25:00,24.0,273,16,5,275,15,4,1,1,0,2020-07-23
2020-07-23 08:50:00,2020-07-24 08:50:00,24.0,273,16,5,275,15,4,1,1,0,2020-07-23
2020-07-23 09:05:00,2020-07-24 09:05:00,24.0,273,16,5,275,15,5,0,1,0,2020-07-23
2020-07-23 09:25:00,2020-07-24 09:25:00,24.0,273,16,5,275,15,5,0,1,0,2020-07-23
2020-07-23 09:30:00,2020-07-24 09:30:00,24.0,273,16,5,275,15,5,0,1,0,2020-07-23
2020-07-23 09:35:00,2020-07-24 09:35:00,24.0,273,16,5,275,15,5,0,1,0,2020-07-23
2020-07-23 09:45:00,2020-07-24 09:45:00,24.0,273,16,5,275,15,5,0,1,0,2020-07-23
2020-07-23 10:05:00,2020-07-24 10:05:00,24.0,273,16,2,275,15,2,0,1,0,2020-07-23
2020-07-23 10:30:00,2020-07-24 10:30:00,24.0,273,16,2,275,15,2,0,1,0,2020-07-23
2020-07-23 15:25:00,2020-07-23 17:25:00,2.0,273,16,1,275,15,1,0,1,0,2020-07-23
2020-07-23 23:50:00,2020-07-24 23:50:00,24.0,273,16,1,275,15,1,0,1,0,2020-07-23
2020-07-24 08:05:00,2020-07-25 08:05:00,24.0,273,8,3,275,8,4,-1,0,0,2020-07-24
2020-07-24 08:15:00,2020-07-25 08:15:00,24.0,273,8,3,275,8,4,-1,0,0,2020-07-24
2020-07-24 08:30:00,2020-07-25 08:30:00,24.0,273,8,3,275,8,4,-1,0,0,2020-07-24
2020-07-24 09:00:00,2020-07-25 09:00:00,24.0,273,8,1,275,8,1,0,0,0,2020-07-24
2020-07-24 10:05:00,2020-07-24 19:05:00,9.0,273,8,2,275,15,1,1,-7,0,2020-07-24
2020-07-24 10:30:00,2020-07-25 10:30:00,24.0,273,8,2,275,8,1,1,0,0,2020-07-24
2020-07-24 11:40:00,2020-07-25 11:40:00,24.0,273,8,1,275,8,1,0,0,0,2020-07-24
2020-07-24 21:35:00,2020-07-25 21:35:00,24.0,273,8,1,275,8,1,0,0,0,2020-07-24
2020-07-25 09:15:00,2020-07-26 09:15:00,24.0,273,3,1,275,3,1,0,0,0,2020-07-25
2020-07-25 11:45:00,2020-07-26 11:45:00,24.0,273,3,1,275,3,1,0,0,0,2020-07-25
2020-07-25 20:50:00,2020-07-26 20:50:00,24.0,273,3,1,275,3,1,0,0,0,2020-07-25
2020-07-26 02:10:00,2020-07-27 02:10:00,24.0,273,1,1,275,2,1,0,-1,0,2020-07-26
2020-07-27 02:00:00,2020-08-27 02:00:00,744.0,273,12,1,280,14,1,0,-2,0,2020-07-27
2020-07-27 08:05:00,2020-07-28 08:05:00,24.0,273,12,4,275,13,4,0,-1,0,2020-07-27
2020-07-27 08:10:00,2020-07-28 08:10:00,24.0,273,12,4,275,13,4,0,-1,0,2020-07-27
2020-07-27 08:30:00,2020-07-28 08:30:00,24.0,273,12,4,275,13,4,0,-1,0,2020-07-27
2020-07-27 08:45:00,2020-07-28 08:45:00,24.0,273,12,4,275,13,4,0,-1,0,2020-07-27
2020-07-27 09:00:00,2020-07-28 09:00:00,24.0,273,12,4,275,13,2,2,-1,0,2020-07-27
2020-07-27 09:00:00,2020-07-27 21:00:00,12.0,273,12,4,275,2,1,3,10,0,2020-07-27
2020-07-27 09:00:00,2020-07-29 09:00:00,48.0,273,12,4,275,13,5,-1,-1,0,2020-07-27
2020-07-27 09:20:00,2020-07-28 09:20:00,24.0,273,12,4,275,13,2,2,-1,0,2020-07-27
2020-07-27 10:10:00,2020-07-28 10:10:00,24.0,273,12,2,275,13,2,0,-1,0,2020-07-27
2020-07-27 10:10:00,2020-07-28 10:10:00,24.0,273,12,2,275,13,2,0,-1,0,2020-07-27
2020-07-27 11:05:00,2020-07-28 11:05:00,24.0,273,12,1,275,13,1,0,-1,0,2020-07-27
2020-07-28 08:00:00,2020-07-29 08:00:00,24.0,273,15,5,275,13,4,1,2,0,2020-07-28
2020-07-28 08:15:00,2020-07-29 08:15:00,24.0,273,15,5,275,13,4,1,2,0,2020-07-28
2020-07-28 08:20:00,2020-07-29 08:20:00,24.0,273,15,5,275,13,4,1,2,0,2020-07-28
2020-07-28 08:55:00,2020-07-28 20:55:00,12.0,273,15,5,275,13,1,4,2,0,2020-07-28
2020-07-28 08:55:00,2020-07-29 08:55:00,24.0,273,15,5,275,13,4,1,2,0,2020-07-28
2020-07-28 09:05:00,2020-07-29 09:05:00,24.0,273,15,5,275,13,5,0,2,0,2020-07-28
2020-07-28 09:20:00,2020-07-29 09:20:00,24.0,273,15,5,275,13,5,0,2,0,2020-07-28
2020-07-28 09:20:00,2020-07-28 14:20:00,5.0,273,15,5,275,13,1,4,2,0,2020-07-28
2020-07-28 09:35:00,2020-07-29 09:35:00,24.0,273,15,5,275,13,5,0,2,0,2020-07-28
2020-07-28 09:45:00,2020-07-29 09:45:00,24.0,273,15,5,275,13,5,0,2,0,2020-07-28
2020-07-28 10:10:00,2020-07-28 19:10:00,9.0,273,15,1,275,13,1,0,2,0,2020-07-28
2020-07-28 12:15:00,2020-07-29 12:15:00,24.0,273,15,1,275,13,1,0,2,0,2020-07-28
2020-07-28 13:40:00,2020-07-29 13:40:00,24.0,273,15,1,275,13,1,0,2,0,2020-07-28
2020-07-28 15:20:00,2020-07-28 17:20:00,2.0,273,15,1,275,13,1,0,2,0,2020-07-28
2020-07-28 22:00:00,2020-07-29 22:00:00,24.0,273,15,1,275,13,1,0,2,0,2020-07-28
2020-07-29 05:05:00,2020-07-30 00:05:00,19.0,273,13,1,275,12,1,0,1,0,2020-07-29
2020-07-29 08:20:00,2020-07-30 08:20:00,24.0,273,13,5,275,12,5,0,1,0,2020-07-29
2020-07-29 08:20:00,2020-07-30 08:20:00,24.0,273,13,5,275,12,5,0,1,0,2020-07-29
2020-07-29 08:45:00,2020-07-30 08:45:00,24.0,273,13,5,275,12,5,0,1,0,2020-07-29
2020-07-29 08:55:00,2020-07-30 08:55:00,24.0,273,13,5,275,12,5,0,1,0,2020-07-29
2020-07-29 08:55:00,2020-07-30 08:55:00,24.0,273,13,5,275,12,5,0,1,0,2020-07-29
2020-07-29 09:00:00,2020-07-29 21:00:00,12.0,273,13,5,275,13,1,4,0,0,2020-07-29
2020-07-29 09:05:00,2020-07-30 09:05:00,24.0,273,13,5,275,12,4,1,1,0,2020-07-29
2020-07-29 09:10:00,2020-07-30 09:10:00,24.0,273,13,5,275,12,4,1,1,0,2020-07-29
2020-07-29 09:25:00,2020-07-30 09:25:00,24.0,273,13,5,275,12,4,1,1,0,2020-07-29
2020-07-29 09:30:00,2020-07-30 09:30:00,24.0,273,13,5,275,12,4,1,1,0,2020-07-29
2020-07-29 20:05:00,2020-07-30 20:05:00,24.0,273,13,2,275,12,2,0,1,0,2020-07-29
2020-07-29 20:20:00,2020-08-05 19:20:00,167.0,273,13,2,280,15,2,0,-2,0,2020-07-29
2020-07-30 08:20:00,2020-07-31 08:20:00,24.0,273,12,6,275,12,5,1,0,0,2020-07-30
2020-07-30 08:25:00,2020-07-31 08:25:00,24.0,273,12,6,275,12,5,1,0,0,2020-07-30
2020-07-30 08:35:00,2020-07-31 08:35:00,24.0,273,12,6,275,12,5,1,0,0,2020-07-30
2020-07-30 08:50:00,2020-07-30 20:50:00,12.0,273,12,6,275,12,2,4,0,0,2020-07-30
2020-07-30 08:50:00,2020-07-31 08:50:00,24.0,273,12,6,275,12,5,1,0,0,2020-07-30
2020-07-30 08:55:00,2020-07-31 08:55:00,24.0,273,12,6,275,12,5,1,0,0,2020-07-30
2020-07-30 09:25:00,2020-07-31 09:25:00,24.0,273,12,4,275,12,4,0,0,0,2020-07-30
2020-07-30 09:30:00,2020-07-31 09:30:00,24.0,273,12,4,275,12,4,0,0,0,2020-07-30
2020-07-30 09:35:00,2020-07-31 09:35:00,24.0,273,12,4,275,12,4,0,0,0,2020-07-30
2020-07-30 09:35:00,2020-07-31 09:35:00,24.0,273,12,4,275,12,4,0,0,0,2020-07-30
2020-07-30 10:00:00,2020-07-31 10:00:00,24.0,273,12,2,275,12,2,0,0,0,2020-07-30
2020-07-30 10:05:00,2020-07-31 10:05:00,24.0,273,12,2,275,12,2,0,0,0,2020-07-30
2020-07-31 08:25:00,2020-08-01 08:25:00,24.0,273,7,2,280,6,2,0,1,0,2020-07-31
2020-07-31 08:30:00,2020-08-01 08:30:00,24.0,273,7,2,280,6,2,0,1,0,2020-07-31
2020-07-31 09:00:00,2020-07-31 17:00:00,8.0,273,7,2,275,12,1,1,-5,0,2020-07-31
2020-07-31 09:05:00,2020-08-01 09:05:00,24.0,273,7,2,280,6,1,1,1,0,2020-07-31
2020-07-31 10:00:00,2020-08-01 10:00:00,24.0,273,7,1,280,6,1,0,1,0,2020-07-31
2020-07-31 18:15:00,2020-08-01 18:15:00,24.0,273,7,1,280,6,1,0,1,0,2020-07-31
2020-07-31 20:55:00,2020-08-01 20:55:00,24.0,273,7,1,280,6,1,0,1,0,2020-07-31
2020-08-03 08:10:00,2020-08-04 08:10:00,24.0,281,14,7,280,15,7,0,-1,0,2020-08-03
2020-08-03 08:15:00,2020-08-04 08:15:00,24.0,281,14,7,280,15,7,0,-1,0,2020-08-03
2020-08-03 08:30:00,2020-08-04 08:30:00,24.0,281,14,7,280,15,7,0,-1,0,2020-08-03
2020-08-03 08:30:00,2020-08-04 08:30:00,24.0,281,14,7,280,15,7,0,-1,0,2020-08-03
2020-08-03 08:40:00,2020-08-04 08:40:00,24.0,281,14,7,280,15,7,0,-1,0,2020-08-03
2020-08-03 08:50:00,2020-08-04 08:50:00,24.0,281,14,7,280,15,7,0,-1,0,2020-08-03
2020-08-03 08:55:00,2020-08-04 08:55:00,24.0,281,14,7,280,15,7,0,-1,0,2020-08-03
2020-08-03 09:00:00,2020-08-04 09:00:00,24.0,281,14,3,280,15,3,0,-1,0,2020-08-03
2020-08-03 09:25:00,2020-08-04 09:25:00,24.0,281,14,3,280,15,3,0,-1,0,2020-08-03
2020-08-03 09:45:00,2020-08-04 09:45:00,24.0,281,14,3,280,15,3,0,-1,0,2020-08-03
2020-08-03 10:05:00,2020-08-04 10:05:00,24.0,281,14,2,280,15,2,0,-1,0,2020-08-03
2020-08-03 10:15:00,2020-08-04 10:15:00,24.0,281,14,2,280,15,2,0,-1,0,2020-08-03
2020-08-03 12:00:00,2020-08-04 12:00:00,24.0,281,14,2,280,15,2,0,-1,0,2020-08-03
2020-08-03 12:45:00,2020-08-04 12:45:00,24.0,281,14,2,280,15,2,0,-1,0,2020-08-03
2020-08-04 02:00:00,2020-09-04 02:00:00,744.0,281,13,1,230,14,1,0,-1,0,2020-08-04
2020-08-04 08:05:00,2020-08-05 08:05:00,24.0,281,13,4,280,15,4,0,-2,0,2020-08-04
2020-08-04 08:35:00,2020-08-05 08:35:00,24.0,281,13,4,280,15,4,0,-2,0,2020-08-04
2020-08-04 08:40:00,2020-08-05 08:40:00,24.0,281,13,4,280,15,4,0,-2,0,2020-08-04
2020-08-04 08:55:00,2020-08-05 08:55:00,24.0,281,13,4,280,15,4,0,-2,0,2020-08-04
2020-08-04 09:10:00,2020-08-05 09:10:00,24.0,281,13,5,280,15,5,0,-2,0,2020-08-04
2020-08-04 09:20:00,2020-08-05 09:20:00,24.0,281,13,5,280,15,5,0,-2,0,2020-08-04
2020-08-04 09:25:00,2020-08-05 09:25:00,24.0,281,13,5,280,15,5,0,-2,0,2020-08-04
2020-08-04 09:25:00,2020-08-05 09:25:00,24.0,281,13,5,280,15,5,0,-2,0,2020-08-04
2020-08-04 09:45:00,2020-08-05 09:45:00,24.0,281,13,5,280,15,5,0,-2,0,2020-08-04
2020-08-04 11:10:00,2020-08-05 11:10:00,24.0,281,13,1,280,15,1,0,-2,0,2020-08-04
2020-08-04 13:45:00,2020-08-04 19:45:00,6.0,281,13,1,280,15,1,0,-2,0,2020-08-04
2020-08-04 16:10:00,2020-08-05 16:10:00,24.0,281,13,1,280,15,1,0,-2,0,2020-08-04
2020-08-05 08:10:00,2020-08-06 08:10:00,24.0,281,17,7,280,16,6,1,1,0,2020-08-05
2020-08-05 08:15:00,2020-08-06 08:15:00,24.0,281,17,7,280,16,6,1,1,0,2020-08-05
2020-08-05 08:25:00,2020-08-06 08:25:00,24.0,281,17,7,280,16,6,1,1,0,2020-08-05
2020-08-05 08:30:00,2020-08-05 19:30:00,11.0,281,17,7,280,15,2,5,2,0,2020-08-05
2020-08-05 08:35:00,2020-08-06 08:35:00,24.0,281,17,7,280,16,6,1,1,0,2020-08-05
2020-08-05 08:40:00,2020-08-06 08:40:00,24.0,281,17,7,280,16,6,1,1,0,2020-08-05
2020-08-05 08:55:00,2020-08-06 08:55:00,24.0,281,17,7,280,16,6,1,1,0,2020-08-05
2020-08-05 09:00:00,2020-08-05 22:00:00,13.0,281,17,5,280,15,2,3,2,0,2020-08-05
2020-08-05 09:05:00,2020-08-06 09:05:00,24.0,281,17,5,280,16,4,1,1,0,2020-08-05
2020-08-05 09:15:00,2020-08-06 09:15:00,24.0,281,17,5,280,16,4,1,1,0,2020-08-05
2020-08-05 09:15:00,2020-08-06 09:15:00,24.0,281,17,5,280,16,4,1,1,0,2020-08-05
2020-08-05 09:30:00,2020-08-06 09:30:00,24.0,281,17,5,280,16,4,1,1,0,2020-08-05
2020-08-05 10:00:00,2020-08-06 10:00:00,24.0,281,17,1,280,16,1,0,1,0,2020-08-05
2020-08-05 11:00:00,2020-08-06 11:00:00,24.0,281,17,2,280,16,2,0,1,0,2020-08-05
2020-08-05 11:10:00,2020-08-06 11:10:00,24.0,281,17,2,280,16,2,0,1,0,2020-08-05
2020-08-05 16:25:00,2020-08-05 22:25:00,6.0,281,17,1,280,15,2,-1,2,0,2020-08-05
2020-08-05 20:10:00,2020-08-06 20:10:00,24.0,281,17,1,280,16,1,0,1,0,2020-08-05
2020-08-06 08:20:00,2020-08-07 08:20:00,24.0,281,15,6,280,14,6,0,1,0,2020-08-06
2020-08-06 08:25:00,2020-08-07 08:25:00,24.0,281,15,6,280,14,6,0,1,0,2020-08-06
2020-08-06 08:25:00,2020-08-07 08:25:00,24.0,281,15,6,280,14,6,0,1,0,2020-08-06
2020-08-06 08:35:00,2020-08-07 08:35:00,24.0,281,15,6,280,14,6,0,1,0,2020-08-06
2020-08-06 08:35:00,2020-08-07 08:35:00,24.0,281,15,6,280,14,6,0,1,0,2020-08-06
2020-08-06 08:50:00,2020-08-07 08:50:00,24.0,281,15,6,280,14,6,0,1,0,2020-08-06
2020-08-06 09:25:00,2020-08-07 09:25:00,24.0,281,15,4,280,14,4,0,1,0,2020-08-06
2020-08-06 09:35:00,2020-08-07 09:35:00,24.0,281,15,4,280,14,4,0,1,0,2020-08-06
2020-08-06 09:40:00,2020-08-07 09:40:00,24.0,281,15,4,280,14,4,0,1,0,2020-08-06
2020-08-06 09:50:00,2020-08-07 09:50:00,24.0,281,15,4,280,14,4,0,1,0,2020-08-06
2020-08-06 10:00:00,2020-08-07 10:00:00,24.0,281,15,3,280,14,2,1,1,0,2020-08-06
2020-08-06 10:00:00,2020-08-06 19:00:00,9.0,281,15,3,280,16,1,2,-1,0,2020-08-06
2020-08-06 10:25:00,2020-08-07 10:25:00,24.0,281,15,3,280,14,2,1,1,0,2020-08-06
2020-08-06 19:30:00,2020-08-07 19:30:00,24.0,281,15,1,280,14,1,0,1,0,2020-08-06
2020-08-06 21:15:00,2020-08-07 21:15:00,24.0,281,15,1,280,14,1,0,1,0,2020-08-06
2020-08-07 07:50:00,2020-08-08 07:50:00,24.0,281,9,1,280,10,1,0,-1,0,2020-08-07
2020-08-07 08:30:00,2020-08-08 08:30:00,24.0,281,9,1,280,10,1,0,-1,0,2020-08-07
2020-08-07 09:10:00,2020-08-08 09:10:00,24.0,281,9,3,280,10,3,0,-1,0,2020-08-07
2020-08-07 09:15:00,2020-08-08 09:15:00,24.0,281,9,3,280,10,3,0,-1,0,2020-08-07
2020-08-07 09:45:00,2020-08-08 09:45:00,24.0,281,9,3,280,10,3,0,-1,0,2020-08-07
2020-08-07 10:10:00,2020-08-08 10:10:00,24.0,281,9,2,280,10,2,0,-1,0,2020-08-07
2020-08-07 10:20:00,2020-08-08 10:20:00,24.0,281,9,2,280,10,2,0,-1,0,2020-08-07
2020-08-07 19:50:00,2020-08-08 19:50:00,24.0,281,9,1,280,10,1,0,-1,0,2020-08-07
2020-08-07 21:50:00,2020-08-08 21:50:00,24.0,281,9,1,280,10,1,0,-1,0,2020-08-07
2020-08-08 01:30:00,2020-08-09 01:30:00,24.0,281,6,2,280,6,2,0,0,0,2020-08-08
2020-08-08 01:50:00,2020-08-09 01:50:00,24.0,281,6,2,280,6,2,0,0,0,2020-08-08
2020-08-08 09:35:00,2020-08-09 09:35:00,24.0,281,6,1,280,6,1,0,0,0,2020-08-08
2020-08-08 19:55:00,2020-08-09 19:55:00,24.0,281,6,1,280,6,1,0,0,0,2020-08-08
2020-08-08 20:40:00,2020-08-09 20:40:00,24.0,281,6,1,280,6,1,0,0,0,2020-08-08
2020-08-08 21:05:00,2020-08-09 21:05:00,24.0,281,6,1,280,6,1,0,0,0,2020-08-08
2020-08-09 01:35:00,2020-08-10 01:35:00,24.0,281,9,1,280,7,1,0,2,0,2020-08-09
2020-08-09 02:00:00,2020-09-09 02:00:00,744.0,281,9,1,230,10,1,0,-1,0,2020-08-09
2020-08-09 05:00:00,2020-08-10 05:00:00,24.0,281,9,1,280,7,1,0,2,0,2020-08-09
2020-08-09 08:25:00,2020-08-10 08:25:00,24.0,281,9,1,280,7,1,0,2,0,2020-08-09
2020-08-09 10:30:00,2020-08-11 00:30:00,38.0,281,9,1,280,18,1,0,-9,0,2020-08-09
2020-08-09 11:00:00,2020-08-10 11:00:00,24.0,281,9,1,280,7,1,0,2,0,2020-08-09
2020-08-09 13:20:00,2020-08-10 13:20:00,24.0,281,9,1,280,7,1,0,2,0,2020-08-09
2020-08-09 21:30:00,2020-08-10 21:30:00,24.0,281,9,1,280,7,1,0,2,0,2020-08-09
2020-08-09 23:35:00,2020-08-10 23:35:00,24.0,281,9,1,280,7,1,0,2,0,2020-08-09
2020-08-10 08:10:00,2020-08-11 08:10:00,24.0,281,15,6,280,18,6,0,-3,0,2020-08-10
2020-08-10 08:10:00,2020-08-11 08:10:00,24.0,281,15,6,280,18,6,0,-3,0,2020-08-10
2020-08-10 08:15:00,2020-08-11 08:15:00,24.0,281,15,6,280,18,6,0,-3,0,2020-08-10
2020-08-10 08:15:00,2020-08-11 08:15:00,24.0,281,15,6,280,18,6,0,-3,0,2020-08-10
2020-08-10 08:30:00,2020-08-11 08:30:00,24.0,281,15,6,280,18,6,0,-3,0,2020-08-10
2020-08-10 08:40:00,2020-08-11 08:40:00,24.0,281,15,6,280,18,6,0,-3,0,2020-08-10
2020-08-10 09:00:00,2020-08-11 09:00:00,24.0,281,15,5,280,18,5,0,-3,0,2020-08-10
2020-08-10 09:10:00,2020-08-11 09:10:00,24.0,281,15,5,280,18,5,0,-3,0,2020-08-10
2020-08-10 09:15:00,2020-08-11 09:15:00,24.0,281,15,5,280,18,5,0,-3,0,2020-08-10
2020-08-10 09:35:00,2020-08-11 09:35:00,24.0,281,15,5,280,18,5,0,-3,0,2020-08-10
2020-08-10 09:35:00,2020-08-11 09:35:00,24.0,281,15,5,280,18,5,0,-3,0,2020-08-10
2020-08-10 10:00:00,2020-08-11 10:00:00,24.0,281,15,4,280,18,5,-1,-3,0,2020-08-10
2020-08-10 10:05:00,2020-08-11 10:05:00,24.0,281,15,4,280,18,5,-1,-3,0,2020-08-10
2020-08-10 10:15:00,2020-08-11 10:15:00,24.0,281,15,4,280,18,5,-1,-3,0,2020-08-10
2020-08-10 10:35:00,2020-08-11 10:35:00,24.0,281,15,4,280,18,5,-1,-3,0,2020-08-10
2020-08-11 02:00:00,2020-09-11 02:00:00,744.0,281,16,1,230,11,1,0,5,0,2020-08-11
2020-08-11 08:15:00,2020-08-11 10:15:00,2.0,281,16,5,280,18,5,0,-2,0,2020-08-11
2020-08-11 08:20:00,2020-08-12 08:20:00,24.0,281,16,5,280,13,4,1,3,0,2020-08-11
2020-08-11 08:25:00,2020-08-12 08:25:00,24.0,281,16,5,280,13,4,1,3,0,2020-08-11
2020-08-11 08:30:00,2020-08-12 08:30:00,24.0,281,16,5,280,13,4,1,3,0,2020-08-11
2020-08-11 08:40:00,2020-08-12 08:40:00,24.0,281,16,5,280,13,4,1,3,0,2020-08-11
2020-08-11 09:00:00,2020-08-11 18:00:00,9.0,281,16,7,280,18,1,6,-2,0,2020-08-11
2020-08-11 09:00:00,2020-08-12 09:00:00,24.0,281,16,7,280,13,6,1,3,0,2020-08-11
2020-08-11 09:00:00,2020-08-12 09:00:00,24.0,281,16,7,280,13,6,1,3,0,2020-08-11
2020-08-11 09:10:00,2020-08-12 09:10:00,24.0,281,16,7,280,13,6,1,3,0,2020-08-11
2020-08-11 09:25:00,2020-08-12 09:25:00,24.0,281,16,7,280,13,6,1,3,0,2020-08-11
2020-08-11 09:50:00,2020-08-12 09:50:00,24.0,281,16,7,280,13,6,1,3,0,2020-08-11
2020-08-11 09:50:00,2020-08-12 09:50:00,24.0,281,16,7,280,13,6,1,3,0,2020-08-11
2020-08-11 10:10:00,2020-08-12 10:10:00,24.0,281,16,1,280,13,1,0,3,0,2020-08-11
2020-08-11 11:35:00,2020-08-12 11:35:00,24.0,281,16,2,280,13,2,0,3,0,2020-08-11
2020-08-11 11:50:00,2020-08-12 11:50:00,24.0,281,16,2,280,13,2,0,3,0,2020-08-11
2020-08-12 08:15:00,2020-08-13 08:15:00,24.0,281,9,3,280,9,3,0,0,5.3 %,2020-08-12
2020-08-12 08:25:00,2020-08-13 08:25:00,24.0,281,9,3,280,9,3,0,0,5.3 %,2020-08-12
2020-08-12 08:40:00,2020-08-13 08:40:00,24.0,281,9,3,280,9,3,0,0,5.3 %,2020-08-12
2020-08-12 09:20:00,2020-08-13 09:20:00,24.0,281,9,2,280,9,2,0,0,5.3 %,2020-08-12
2020-08-12 09:40:00,2020-08-13 09:40:00,24.0,281,9,2,280,9,2,0,0,5.3 %,2020-08-12
2020-08-12 10:05:00,2020-08-13 10:05:00,24.0,281,9,3,280,9,3,0,0,5.3 %,2020-08-12
2020-08-12 10:05:00,2020-08-13 10:05:00,24.0,281,9,3,280,9,3,0,0,5.3 %,2020-08-12
2020-08-12 10:30:00,2020-08-13 10:30:00,24.0,281,9,3,280,9,3,0,0,5.3 %,2020-08-12
2020-08-12 19:10:00,2020-08-13 19:10:00,24.0,281,9,1,280,9,1,0,0,5.3 %,2020-08-12
2020-08-13 08:20:00,2020-08-14 08:20:00,24.0,281,10,5,280,10,5,0,0,0,2020-08-13
2020-08-13 08:25:00,2020-08-14 08:25:00,24.0,281,10,5,280,10,5,0,0,0,2020-08-13
2020-08-13 08:35:00,2020-08-14 08:35:00,24.0,281,10,5,280,10,5,0,0,0,2020-08-13
2020-08-13 08:50:00,2020-08-14 08:50:00,24.0,281,10,5,280,10,5,0,0,0,2020-08-13
2020-08-13 08:55:00,2020-08-14 08:55:00,24.0,281,10,5,280,10,5,0,0,0,2020-08-13
2020-08-13 09:05:00,2020-08-14 09:05:00,24.0,281,10,5,280,10,5,0,0,0,2020-08-13
2020-08-13 09:15:00,2020-08-14 09:15:00,24.0,281,10,5,280,10,5,0,0,0,2020-08-13
2020-08-13 09:15:00,2020-08-14 09:15:00,24.0,281,10,5,280,10,5,0,0,0,2020-08-13
2020-08-13 09:20:00,2020-08-14 09:20:00,24.0,281,10,5,280,10,5,0,0,0,2020-08-13
2020-08-13 09:25:00,2020-08-14 09:25:00,24.0,281,10,5,280,10,5,0,0,0,2020-08-13
2020-08-14 08:10:00,2020-08-15 08:10:00,24.0,281,12,4,280,12,4,0,0,0,2020-08-14
2020-08-14 08:20:00,2020-08-15 08:20:00,24.0,281,12,4,280,12,4,0,0,0,2020-08-14
2020-08-14 08:30:00,2020-08-15 08:30:00,24.0,281,12,4,280,12,4,0,0,0,2020-08-14
2020-08-14 08:40:00,2020-08-15 08:40:00,24.0,281,12,4,280,12,4,0,0,0,2020-08-14
2020-08-14 09:05:00,2020-08-15 09:05:00,24.0,281,12,4,280,12,4,0,0,0,2020-08-14
2020-08-14 09:20:00,2020-08-15 09:20:00,24.0,281,12,4,280,12,4,0,0,0,2020-08-14
2020-08-14 09:35:00,2020-08-15 09:35:00,24.0,281,12,4,280,12,4,0,0,0,2020-08-14
2020-08-14 09:50:00,2020-08-15 09:50:00,24.0,281,12,4,280,12,4,0,0,0,2020-08-14
2020-08-14 10:10:00,2020-08-15 10:10:00,24.0,281,12,3,280,12,3,0,0,0,2020-08-14
2020-08-14 10:15:00,2020-08-15 10:15:00,24.0,281,12,3,280,12,3,0,0,0,2020-08-14
2020-08-14 10:15:00,2020-08-15 10:15:00,24.0,281,12,3,280,12,3,0,0,0,2020-08-14
2020-08-14 22:00:00,2020-08-15 22:00:00,24.0,281,12,1,280,12,1,0,0,0,2020-08-14
2020-08-15 09:20:00,2020-08-16 09:20:00,24.0,281,3,1,280,3,1,0,0,0,2020-08-15
2020-08-15 10:05:00,2020-08-16 14:05:00,28.0,281,3,1,280,3,1,0,0,0,2020-08-15
2020-08-15 11:40:00,2020-08-16 11:40:00,24.0,281,3,1,280,3,1,0,0,0,2020-08-15
2020-08-16 01:05:00,2020-08-17 01:05:00,24.0,281,4,1,280,4,1,0,0,0,2020-08-16
2020-08-16 11:30:00,2020-08-17 11:30:00,24.0,281,4,1,280,4,1,0,0,0,2020-08-16
2020-08-16 18:25:00,2020-08-17 18:25:00,24.0,281,4,1,280,4,1,0,0,0,2020-08-16
2020-08-16 19:05:00,2020-08-17 19:05:00,24.0,281,4,1,280,4,1,0,0,0,2020-08-16
2020-08-17 02:00:00,2020-09-17 02:00:00,744.0,281,11,1,230,9,1,0,2,0,2020-08-17
2020-08-17 08:20:00,2020-08-18 08:20:00,24.0,281,11,1,280,11,1,0,0,0,2020-08-17
2020-08-17 09:00:00,2020-08-18 09:00:00,24.0,281,11,5,280,11,5,0,0,0,2020-08-17
2020-08-17 09:05:00,2020-08-18 09:05:00,24.0,281,11,5,280,11,5,0,0,0,2020-08-17
2020-08-17 09:10:00,2020-08-18 09:10:00,24.0,281,11,5,280,11,5,0,0,0,2020-08-17
2020-08-17 09:30:00,2020-08-18 09:30:00,24.0,281,11,5,280,11,5,0,0,0,2020-08-17
2020-08-17 09:50:00,2020-08-18 09:50:00,24.0,281,11,5,280,11,5,0,0,0,2020-08-17
2020-08-17 10:10:00,2020-08-18 10:10:00,24.0,281,11,2,280,11,2,0,0,0,2020-08-17
2020-08-17 10:40:00,2020-08-18 10:40:00,24.0,281,11,2,280,11,2,0,0,0,2020-08-17
2020-08-17 13:55:00,2020-08-18 13:55:00,24.0,281,11,1,280,11,1,0,0,0,2020-08-17
2020-08-17 18:25:00,2020-08-18 18:25:00,24.0,281,11,1,280,11,1,0,0,0,2020-08-17
2020-08-18 08:00:00,2020-08-19 08:00:00,24.0,281,14,5,280,13,5,0,1,0,2020-08-18
2020-08-18 08:10:00,2020-08-19 08:10:00,24.0,281,14,5,280,13,5,0,1,0,2020-08-18
2020-08-18 08:20:00,2020-08-19 08:20:00,24.0,281,14,5,280,13,5,0,1,0,2020-08-18
2020-08-18 08:30:00,2020-08-19 08:30:00,24.0,281,14,5,280,13,5,0,1,0,2020-08-18
2020-08-18 08:30:00,2020-08-19 08:30:00,24.0,281,14,5,280,13,5,0,1,0,2020-08-18
2020-08-18 09:00:00,2020-08-18 17:00:00,8.0,281,14,7,280,11,1,6,3,0,2020-08-18
2020-08-18 09:00:00,2020-08-19 09:00:00,24.0,281,14,7,280,13,6,1,1,0,2020-08-18
2020-08-18 09:00:00,2020-08-19 09:00:00,24.0,281,14,7,280,13,6,1,1,0,2020-08-18
2020-08-18 09:05:00,2020-08-19 09:05:00,24.0,281,14,7,280,13,6,1,1,0,2020-08-18
2020-08-18 09:30:00,2020-08-19 09:30:00,24.0,281,14,7,280,13,6,1,1,0,2020-08-18
2020-08-18 09:30:00,2020-08-19 09:30:00,24.0,281,14,7,280,13,6,1,1,0,2020-08-18
2020-08-18 09:50:00,2020-08-19 09:50:00,24.0,281,14,7,280,13,6,1,1,0,2020-08-18
2020-08-18 10:50:00,2020-08-19 10:50:00,24.0,281,14,1,280,13,1,0,1,0,2020-08-18
2020-08-18 18:25:00,2020-08-19 18:25:00,24.0,281,14,1,280,13,1,0,1,0,2020-08-18
2020-08-19 08:15:00,2020-08-20 08:15:00,24.0,281,12,6,280,12,6,0,0,0,2020-08-19
2020-08-19 08:20:00,2020-08-20 08:20:00,24.0,281,12,6,280,12,6,0,0,0,2020-08-19
2020-08-19 08:30:00,2020-08-20 08:30:00,24.0,281,12,6,280,12,6,0,0,0,2020-08-19
2020-08-19 08:35:00,2020-08-20 08:35:00,24.0,281,12,6,280,12,6,0,0,0,2020-08-19
2020-08-19 08:35:00,2020-08-20 08:35:00,24.0,281,12,6,280,12,6,0,0,0,2020-08-19
2020-08-19 08:55:00,2020-08-20 08:55:00,24.0,281,12,6,280,12,6,0,0,0,2020-08-19
2020-08-19 09:00:00,2020-08-20 09:00:00,24.0,281,12,4,280,12,4,0,0,0,2020-08-19
2020-08-19 09:10:00,2020-08-20 09:10:00,24.0,281,12,4,280,12,4,0,0,0,2020-08-19
2020-08-19 09:30:00,2020-08-20 09:30:00,24.0,281,12,4,280,12,4,0,0,0,2020-08-19
2020-08-19 09:35:00,2020-08-20 09:35:00,24.0,281,12,4,280,12,4,0,0,0,2020-08-19
2020-08-19 10:55:00,2020-08-20 10:55:00,24.0,281,12,1,280,12,1,0,0,0,2020-08-19
2020-08-19 19:15:00,2020-08-20 19:15:00,24.0,281,12,1,280,12,1,0,0,0,2020-08-19
2020-08-20 08:10:00,2020-08-21 08:10:00,24.0,281,14,6,280,14,6,0,0,0,2020-08-20
2020-08-20 08:20:00,2020-08-21 08:20:00,24.0,281,14,6,280,14,6,0,0,0,2020-08-20
2020-08-20 08:35:00,2020-08-21 08:35:00,24.0,281,14,6,280,14,6,0,0,0,2020-08-20
2020-08-20 08:35:00,2020-08-21 08:35:00,24.0,281,14,6,280,14,6,0,0,0,2020-08-20
2020-08-20 08:40:00,2020-08-21 08:40:00,24.0,281,14,6,280,14,6,0,0,0,2020-08-20
2020-08-20 08:55:00,2020-08-21 08:55:00,24.0,281,14,6,280,14,6,0,0,0,2020-08-20
2020-08-20 09:00:00,2020-08-21 09:00:00,24.0,281,14,3,280,14,3,0,0,0,2020-08-20
2020-08-20 09:05:00,2020-08-21 09:05:00,24.0,281,14,3,280,14,3,0,0,0,2020-08-20
2020-08-20 09:10:00,2020-08-21 09:10:00,24.0,281,14,3,280,14,3,0,0,0,2020-08-20
2020-08-20 10:35:00,2020-08-21 10:35:00,24.0,281,14,1,280,14,1,0,0,0,2020-08-20
2020-08-20 11:10:00,2020-08-21 11:10:00,24.0,281,14,1,280,14,1,0,0,0,2020-08-20
2020-08-20 14:40:00,2020-08-21 14:40:00,24.0,281,14,1,280,14,1,0,0,0,2020-08-20
2020-08-20 21:10:00,2020-08-21 21:10:00,24.0,281,14,1,280,14,1,0,0,0,2020-08-20
2020-08-20 22:05:00,2020-08-21 22:05:00,24.0,281,14,1,280,14,1,0,0,0,2020-08-20
2020-08-21 08:05:00,2020-08-22 08:05:00,24.0,281,8,2,280,8,2,0,0,0,2020-08-21
2020-08-21 08:15:00,2020-08-22 08:15:00,24.0,281,8,2,280,8,2,0,0,0,2020-08-21
2020-08-21 09:35:00,2020-08-22 09:35:00,24.0,281,8,4,280,8,4,0,0,0,2020-08-21
2020-08-21 09:40:00,2020-08-22 09:40:00,24.0,281,8,4,280,8,4,0,0,0,2020-08-21
2020-08-21 09:45:00,2020-08-22 09:45:00,24.0,281,8,4,280,8,4,0,0,0,2020-08-21
2020-08-21 09:45:00,2020-08-22 09:45:00,24.0,281,8,4,280,8,4,0,0,0,2020-08-21
2020-08-21 11:35:00,2020-08-22 11:35:00,24.0,281,8,1,280,8,1,0,0,0,2020-08-21
2020-08-21 15:35:00,2020-08-22 15:35:00,24.0,281,8,1,280,8,1,0,0,0,2020-08-21
2020-08-22 09:05:00,2020-08-23 09:05:00,24.0,281,2,2,280,3,2,0,-1,0,2020-08-22
2020-08-22 09:10:00,2020-08-23 09:10:00,24.0,281,2,2,280,3,2,0,-1,0,2020-08-22
2020-08-23 18:00:00,2020-08-24 18:00:00,24.0,281,2,1,280,2,1,0,0,0,2020-08-23
2020-08-23 21:15:00,2020-08-24 21:15:00,24.0,281,2,1,280,2,1,0,0,0,2020-08-23
2020-08-24 02:00:00,2020-09-24 02:00:00,744.0,281,9,1,230,9,1,0,0,0,2020-08-24
2020-08-24 08:15:00,2020-08-25 08:15:00,24.0,281,9,3,280,7,3,0,2,0,2020-08-24
2020-08-24 08:15:00,2020-08-25 08:15:00,24.0,281,9,3,280,7,3,0,2,0,2020-08-24
2020-08-24 08:40:00,2020-08-25 08:40:00,24.0,281,9,3,280,7,3,0,2,0,2020-08-24
2020-08-24 09:25:00,2020-08-25 09:25:00,24.0,281,9,2,280,7,2,0,2,0,2020-08-24
2020-08-24 09:30:00,2020-08-25 09:30:00,24.0,281,9,2,280,7,2,0,2,0,2020-08-24
2020-08-24 10:05:00,2020-08-25 10:05:00,24.0,281,9,3,280,7,2,1,2,0,2020-08-24
2020-08-24 10:05:00,2020-08-27 10:05:00,72.0,281,9,3,280,14,2,1,-5,0,2020-08-24
2020-08-24 10:30:00,2020-08-25 10:30:00,24.0,281,9,3,280,7,2,1,2,0,2020-08-24
2020-08-25 08:15:00,2020-08-26 08:15:00,24.0,281,9,4,280,11,4,0,-2,0,2020-08-25
2020-08-25 08:30:00,2020-08-26 08:30:00,24.0,281,9,4,280,11,4,0,-2,0,2020-08-25
2020-08-25 08:40:00,2020-08-26 08:40:00,24.0,281,9,4,280,11,4,0,-2,0,2020-08-25
2020-08-25 08:40:00,2020-08-26 08:40:00,24.0,281,9,4,280,11,4,0,-2,0,2020-08-25
2020-08-25 09:00:00,2020-08-26 09:00:00,24.0,281,9,3,280,11,3,0,-2,0,2020-08-25
2020-08-25 09:15:00,2020-08-26 09:15:00,24.0,281,9,3,280,11,3,0,-2,0,2020-08-25
2020-08-25 09:15:00,2020-08-26 09:15:00,24.0,281,9,3,280,11,3,0,-2,0,2020-08-25
2020-08-25 10:10:00,2020-08-26 10:10:00,24.0,281,9,1,280,11,1,0,-2,0,2020-08-25
2020-08-25 11:15:00,2020-08-26 11:15:00,24.0,281,9,1,280,11,1,0,-2,0,2020-08-25
2020-08-26 08:20:00,2020-08-27 08:20:00,24.0,281,13,4,280,14,4,0,-1,0,2020-08-26
2020-08-26 08:30:00,2020-08-27 08:30:00,24.0,281,13,4,280,14,4,0,-1,0,2020-08-26
2020-08-26 08:35:00,2020-08-27 08:35:00,24.0,281,13,4,280,14,4,0,-1,0,2020-08-26
2020-08-26 08:55:00,2020-08-27 08:55:00,24.0,281,13,4,280,14,4,0,-1,0,2020-08-26
2020-08-26 09:00:00,2020-08-27 09:00:00,24.0,281,13,3,280,14,3,0,-1,0,2020-08-26
2020-08-26 09:35:00,2020-08-27 09:35:00,24.0,281,13,3,280,14,3,0,-1,0,2020-08-26
2020-08-26 09:40:00,2020-08-27 09:40:00,24.0,281,13,3,280,14,3,0,-1,0,2020-08-26
2020-08-26 10:10:00,2020-08-27 10:10:00,24.0,281,13,1,280,14,2,-1,-1,0,2020-08-26
2020-08-26 12:45:00,2020-08-27 12:45:00,24.0,281,13,1,280,14,1,0,-1,0,2020-08-26
2020-08-26 13:55:00,2020-08-26 20:55:00,7.0,281,13,1,280,11,1,0,2,0,2020-08-26
2020-08-26 15:45:00,2020-08-27 15:45:00,24.0,281,13,2,280,14,2,0,-1,0,2020-08-26
2020-08-26 15:55:00,2020-08-27 15:55:00,24.0,281,13,2,280,14,2,0,-1,0,2020-08-26
2020-08-26 16:45:00,2020-08-26 19:45:00,3.0,281,13,1,280,11,1,0,2,0,2020-08-26
2020-08-27 07:55:00,2020-08-28 07:55:00,24.0,281,15,1,280,14,1,0,1,0,2020-08-27
2020-08-27 08:15:00,2020-08-28 08:15:00,24.0,281,15,5,280,14,5,0,1,0,2020-08-27
2020-08-27 08:20:00,2020-08-28 08:20:00,24.0,281,15,5,280,14,5,0,1,0,2020-08-27
2020-08-27 08:40:00,2020-08-28 08:40:00,24.0,281,15,5,280,14,5,0,1,0,2020-08-27
2020-08-27 08:45:00,2020-08-28 08:45:00,24.0,281,15,5,280,14,5,0,1,0,2020-08-27
2020-08-27 08:50:00,2020-08-28 08:50:00,24.0,281,15,5,280,14,5,0,1,0,2020-08-27
2020-08-27 09:20:00,2020-08-28 09:20:00,24.0,281,15,5,280,14,5,0,1,0,2020-08-27
2020-08-27 09:25:00,2020-08-28 09:25:00,24.0,281,15,5,280,14,5,0,1,0,2020-08-27
2020-08-27 09:35:00,2020-08-28 09:35:00,24.0,281,15,5,280,14,5,0,1,0,2020-08-27
2020-08-27 09:40:00,2020-08-28 09:40:00,24.0,281,15,5,280,14,5,0,1,0,2020-08-27
2020-08-27 09:45:00,2020-08-28 09:45:00,24.0,281,15,5,280,14,5,0,1,0,2020-08-27
2020-08-27 10:05:00,2020-08-27 18:05:00,8.0,281,15,2,280,14,1,1,1,0,2020-08-27
2020-08-27 10:15:00,2020-08-28 10:15:00,24.0,281,15,2,280,14,1,1,1,0,2020-08-27
2020-08-27 12:50:00,2020-08-28 12:50:00,24.0,281,15,1,280,14,1,0,1,0,2020-08-27
2020-08-27 20:00:00,2020-08-28 15:00:00,19.0,281,15,1,280,14,1,0,1,0,2020-08-27
2020-08-28 07:55:00,2020-08-29 07:55:00,24.0,281,7,1,280,7,1,0,0,0,2020-08-28
2020-08-28 08:20:00,2020-08-29 08:20:00,24.0,281,7,2,280,7,2,0,0,0,2020-08-28
2020-08-28 08:25:00,2020-08-29 08:25:00,24.0,281,7,2,280,7,2,0,0,0,2020-08-28
2020-08-28 09:00:00,2020-08-29 09:00:00,24.0,281,7,2,280,7,2,0,0,0,2020-08-28
2020-08-28 09:35:00,2020-08-29 09:35:00,24.0,281,7,2,280,7,2,0,0,0,2020-08-28
2020-08-28 10:00:00,2020-08-29 10:00:00,24.0,281,7,2,280,7,2,0,0,0,2020-08-28
2020-08-28 10:05:00,2020-08-29 10:05:00,24.0,281,7,2,280,7,2,0,0,0,2020-08-28
2020-08-29 09:00:00,2020-08-30 09:00:00,24.0,281,1,1,280,1,1,0,0,0,2020-08-29
2020-08-30 00:45:00,2020-08-31 00:45:00,24.0,281,2,1,280,4,1,0,-2,0,2020-08-30
2020-08-30 17:10:00,2020-08-31 17:10:00,24.0,281,2,1,280,4,1,0,-2,0,2020-08-30
2020-08-31 07:55:00,2020-09-01 07:55:00,24.0,281,10,1,230,9,1,0,1,0,2020-08-31
2020-08-31 08:20:00,2020-09-01 08:20:00,24.0,281,10,5,230,9,4,1,1,0,2020-08-31
2020-08-31 08:35:00,2020-09-01 08:35:00,24.0,281,10,5,230,9,4,1,1,0,2020-08-31
2020-08-31 08:40:00,2020-09-01 08:40:00,24.0,281,10,5,230,9,4,1,1,0,2020-08-31
2020-08-31 08:45:00,2020-08-31 21:45:00,13.0,281,10,5,280,4,1,4,6,0,2020-08-31
2020-08-31 08:55:00,2020-09-01 08:55:00,24.0,281,10,5,230,9,4,1,1,0,2020-08-31
2020-08-31 09:00:00,2020-08-31 18:00:00,9.0,281,10,3,280,4,1,2,6,0,2020-08-31
2020-08-31 09:00:00,2020-09-01 09:00:00,24.0,281,10,3,230,9,2,1,1,0,2020-08-31
2020-08-31 09:05:00,2020-09-01 09:05:00,24.0,281,10,3,230,9,2,1,1,0,2020-08-31
2020-08-31 10:00:00,2020-09-01 10:00:00,24.0,281,10,1,230,9,1,0,1,0,2020-08-31
2020-09-01 02:00:00,2020-10-01 02:00:00,720.0,233,12,1,207,11,1,0,1,0,2020-09-01
2020-09-01 08:00:00,2020-09-02 08:00:00,24.0,233,12,5,230,11,4,1,1,0,2020-09-01
2020-09-01 08:15:00,2020-09-02 08:15:00,24.0,233,12,5,230,11,4,1,1,0,2020-09-01
2020-09-01 08:25:00,2020-09-02 08:25:00,24.0,233,12,5,230,11,4,1,1,0,2020-09-01
2020-09-01 08:40:00,2020-09-02 08:40:00,24.0,233,12,5,230,11,4,1,1,0,2020-09-01
2020-09-01 08:50:00,2020-09-01 20:50:00,12.0,233,12,5,230,9,1,4,3,0,2020-09-01
2020-09-01 09:05:00,2020-09-02 09:05:00,24.0,233,12,4,230,11,4,0,1,0,2020-09-01
2020-09-01 09:25:00,2020-09-02 09:25:00,24.0,233,12,4,230,11,4,0,1,0,2020-09-01
2020-09-01 09:35:00,2020-09-02 09:35:00,24.0,233,12,4,230,11,4,0,1,0,2020-09-01
2020-09-01 09:40:00,2020-09-02 09:40:00,24.0,233,12,4,230,11,4,0,1,0,2020-09-01
2020-09-01 10:20:00,2020-09-02 10:20:00,24.0,233,12,1,230,11,1,0,1,0,2020-09-01
2020-09-01 21:35:00,2020-09-02 21:35:00,24.0,233,12,1,230,11,1,0,1,0,2020-09-01
2020-09-02 07:55:00,2020-09-03 07:55:00,24.0,233,9,1,230,10,1,0,-1,0,2020-09-02
2020-09-02 08:20:00,2020-09-03 08:20:00,24.0,233,9,4,230,10,3,1,-1,0,2020-09-02
2020-09-02 08:35:00,2020-09-03 08:35:00,24.0,233,9,4,230,10,3,1,-1,0,2020-09-02
2020-09-02 08:45:00,2020-09-03 08:45:00,24.0,233,9,4,230,10,3,1,-1,0,2020-09-02
2020-09-02 08:55:00,2020-09-02 22:55:00,14.0,233,9,4,230,11,1,3,-2,0,2020-09-02
2020-09-02 09:40:00,2020-09-03 09:40:00,24.0,233,9,2,230,10,2,0,-1,0,2020-09-02
2020-09-02 09:50:00,2020-09-03 09:50:00,24.0,233,9,2,230,10,2,0,-1,0,2020-09-02
2020-09-02 10:45:00,2020-09-03 10:45:00,24.0,233,9,1,230,10,1,0,-1,0,2020-09-02
2020-09-02 20:05:00,2020-09-03 20:05:00,24.0,233,9,1,230,10,1,0,-1,0,2020-09-02
2020-09-03 08:00:00,2020-09-04 08:00:00,24.0,233,13,8,230,14,7,1,-1,0,2020-09-03
2020-09-03 08:15:00,2020-09-04 08:15:00,24.0,233,13,8,230,14,7,1,-1,0,2020-09-03
2020-09-03 08:25:00,2020-09-04 08:25:00,24.0,233,13,8,230,14,7,1,-1,0,2020-09-03
2020-09-03 08:25:00,2020-09-04 08:25:00,24.0,233,13,8,230,14,7,1,-1,0,2020-09-03
2020-09-03 08:25:00,2020-09-04 08:25:00,24.0,233,13,8,230,14,7,1,-1,0,2020-09-03
2020-09-03 08:30:00,2020-09-04 08:30:00,24.0,233,13,8,230,14,7,1,-1,0,2020-09-03
2020-09-03 08:40:00,2020-09-03 21:40:00,13.0,233,13,8,230,10,1,7,3,0,2020-09-03
2020-09-03 08:40:00,2020-09-04 08:40:00,24.0,233,13,8,230,14,7,1,-1,0,2020-09-03
2020-09-03 09:05:00,2020-09-04 09:05:00,24.0,233,13,4,230,14,3,1,-1,0,2020-09-03
2020-09-03 09:25:00,2020-09-03 15:25:00,6.0,233,13,4,230,10,1,3,3,0,2020-09-03
2020-09-03 09:30:00,2020-09-04 09:30:00,24.0,233,13,4,230,14,3,1,-1,0,2020-09-03
2020-09-03 09:35:00,2020-09-04 09:35:00,24.0,233,13,4,230,14,3,1,-1,0,2020-09-03
2020-09-03 11:05:00,2020-09-04 11:05:00,24.0,233,13,1,230,14,1,0,-1,0,2020-09-03
2020-09-04 07:55:00,2020-09-05 07:55:00,24.0,233,13,1,230,11,1,0,2,0,2020-09-04
2020-09-04 08:15:00,2020-09-05 08:15:00,24.0,233,13,2,230,11,1,1,2,0,2020-09-04
2020-09-04 08:55:00,2020-09-04 21:55:00,13.0,233,13,2,230,14,1,1,-1,0,2020-09-04
2020-09-04 09:15:00,2020-09-05 09:15:00,24.0,233,13,3,230,11,3,0,2,0,2020-09-04
2020-09-04 09:25:00,2020-09-05 09:25:00,24.0,233,13,3,230,11,3,0,2,0,2020-09-04
2020-09-04 09:40:00,2020-09-05 09:40:00,24.0,233,13,3,230,11,3,0,2,0,2020-09-04
2020-09-04 10:00:00,2020-09-05 10:00:00,24.0,233,13,4,230,11,3,1,2,0,2020-09-04
2020-09-04 10:00:00,2020-09-05 10:00:00,24.0,233,13,4,230,11,3,1,2,0,2020-09-04
2020-09-04 10:05:00,2020-09-04 14:05:00,4.0,233,13,4,230,14,1,3,-1,0,2020-09-04
2020-09-04 10:10:00,2020-09-05 10:10:00,24.0,233,13,4,230,11,3,1,2,0,2020-09-04
2020-09-04 11:00:00,2020-09-05 11:00:00,24.0,233,13,2,230,11,2,0,2,0,2020-09-04
2020-09-04 11:25:00,2020-09-05 11:25:00,24.0,233,13,2,230,11,2,0,2,0,2020-09-04
2020-09-04 15:40:00,2020-09-05 15:40:00,24.0,233,13,1,230,11,1,0,2,0,2020-09-04
2020-09-05 09:10:00,2020-09-06 09:10:00,24.0,233,4,1,230,4,1,0,0,0,2020-09-05
2020-09-05 11:00:00,2020-09-06 11:00:00,24.0,233,4,2,230,4,2,0,0,0,2020-09-05
2020-09-05 11:25:00,2020-09-06 11:25:00,24.0,233,4,2,230,4,2,0,0,0,2020-09-05
2020-09-05 15:00:00,2020-09-06 15:00:00,24.0,233,4,1,230,4,1,0,0,0,2020-09-05
2020-09-06 15:50:00,2020-09-07 15:50:00,24.0,233,2,1,230,3,1,0,-1,0,2020-09-06
2020-09-06 17:00:00,2020-09-07 17:00:00,24.0,233,2,1,230,3,1,0,-1,0,2020-09-06
2020-09-07 02:00:00,2020-10-07 02:00:00,720.0,233,11,1,207,10,2,-1,1,0,2020-09-07
2020-09-07 07:55:00,2020-09-08 07:55:00,24.0,233,11,1,230,10,1,0,1,0,2020-09-07
2020-09-07 08:10:00,2020-09-08 08:10:00,24.0,233,11,5,230,10,4,1,1,0,2020-09-07
2020-09-07 08:10:00,2020-09-08 08:10:00,24.0,233,11,5,230,10,4,1,1,0,2020-09-07
2020-09-07 08:35:00,2020-09-08 08:35:00,24.0,233,11,5,230,10,4,1,1,0,2020-09-07
2020-09-07 08:35:00,2020-09-08 08:35:00,24.0,233,11,5,230,10,4,1,1,0,2020-09-07
2020-09-07 08:55:00,2020-09-07 20:55:00,12.0,233,11,5,230,3,1,4,8,0,2020-09-07
2020-09-07 09:35:00,2020-09-08 09:35:00,24.0,233,11,1,230,10,1,0,1,0,2020-09-07
2020-09-07 10:00:00,2020-09-08 10:00:00,24.0,233,11,3,230,10,3,0,1,0,2020-09-07
2020-09-07 10:00:00,2020-09-08 10:00:00,24.0,233,11,3,230,10,3,0,1,0,2020-09-07
2020-09-07 10:20:00,2020-09-08 10:20:00,24.0,233,11,3,230,10,3,0,1,0,2020-09-07
2020-09-08 07:55:00,2020-09-09 07:55:00,24.0,233,8,1,230,10,1,0,-2,0,2020-09-08
2020-09-08 08:10:00,2020-09-09 08:10:00,24.0,233,8,5,230,10,4,1,-2,0,2020-09-08
2020-09-08 08:40:00,2020-09-09 08:40:00,24.0,233,8,5,230,10,4,1,-2,0,2020-09-08
2020-09-08 08:50:00,2020-09-08 20:50:00,12.0,233,8,5,230,10,1,4,-2,0,2020-09-08
2020-09-08 08:55:00,2020-09-09 08:55:00,24.0,233,8,5,230,10,4,1,-2,0,2020-09-08
2020-09-08 08:55:00,2020-09-09 08:55:00,24.0,233,8,5,230,10,4,1,-2,0,2020-09-08
2020-09-08 10:10:00,2020-09-09 10:10:00,24.0,233,8,1,230,10,1,0,-2,0,2020-09-08
2020-09-08 14:50:00,2020-09-09 14:50:00,24.0,233,8,1,230,10,1,0,-2,0,2020-09-08
2020-09-09 08:00:00,2020-09-10 08:00:00,24.0,233,11,3,230,13,3,0,-2,0,2020-09-09
2020-09-09 08:05:00,2020-09-10 08:05:00,24.0,233,11,3,230,13,3,0,-2,0,2020-09-09
2020-09-09 08:35:00,2020-09-10 08:35:00,24.0,233,11,3,230,13,3,0,-2,0,2020-09-09
2020-09-09 09:00:00,2020-09-10 09:00:00,24.0,233,11,4,230,13,3,1,-2,0,2020-09-09
2020-09-09 09:05:00,2020-09-09 21:05:00,12.0,233,11,4,230,10,1,3,1,0,2020-09-09
2020-09-09 09:35:00,2020-09-10 09:35:00,24.0,233,11,4,230,13,3,1,-2,0,2020-09-09
2020-09-09 09:55:00,2020-09-10 09:55:00,24.0,233,11,4,230,13,3,1,-2,0,2020-09-09
2020-09-09 10:00:00,2020-09-10 10:00:00,24.0,233,11,1,230,13,1,0,-2,0,2020-09-09
2020-09-09 13:00:00,2020-09-10 12:00:00,23.0,233,11,2,230,13,1,1,-2,0,2020-09-09
2020-09-09 13:50:00,2020-09-10 13:50:00,24.0,233,11,2,230,13,1,1,-2,0,2020-09-09
2020-09-09 17:40:00,2020-09-09 19:40:00,2.0,233,11,1,230,10,1,0,1,0,2020-09-09
2020-09-10 07:55:00,2020-09-11 07:55:00,24.0,233,12,1,230,11,1,0,1,0,2020-09-10
2020-09-10 08:05:00,2020-09-11 08:05:00,24.0,233,12,4,230,11,3,1,1,0,2020-09-10
2020-09-10 08:40:00,2020-09-11 08:40:00,24.0,233,12,4,230,11,3,1,1,0,2020-09-10
2020-09-10 08:45:00,2020-09-11 08:45:00,24.0,233,12,4,230,11,3,1,1,0,2020-09-10
2020-09-10 08:55:00,2020-09-10 20:55:00,12.0,233,12,4,230,13,1,3,-1,0,2020-09-10
2020-09-10 09:15:00,2020-09-10 19:15:00,10.0,233,12,3,230,13,2,1,-1,0,2020-09-10
2020-09-10 09:35:00,2020-09-11 09:35:00,24.0,233,12,3,230,11,2,1,1,0,2020-09-10
2020-09-10 09:35:00,2020-09-11 09:35:00,24.0,233,12,3,230,11,2,1,1,0,2020-09-10
2020-09-10 10:05:00,2020-09-11 10:05:00,24.0,233,12,2,230,11,2,0,1,0,2020-09-10
2020-09-10 10:10:00,2020-09-11 10:10:00,24.0,233,12,2,230,11,2,0,1,0,2020-09-10
2020-09-10 13:30:00,2020-09-10 14:30:00,1.0,233,12,1,230,13,1,0,-1,0,2020-09-10
2020-09-10 18:10:00,2020-09-10 19:10:00,1.0,233,12,1,230,13,2,-1,-1,0,2020-09-10
2020-09-11 02:00:00,2020-10-11 02:00:00,720.0,233,8,1,207,2,1,0,6,0,2020-09-11
2020-09-11 08:00:00,2020-09-12 08:00:00,24.0,233,8,4,230,5,3,1,3,0,2020-09-11
2020-09-11 08:05:00,2020-09-12 08:05:00,24.0,233,8,4,230,5,3,1,3,0,2020-09-11
2020-09-11 08:40:00,2020-09-12 08:40:00,24.0,233,8,4,230,5,3,1,3,0,2020-09-11
2020-09-11 08:55:00,2020-09-11 19:55:00,11.0,233,8,4,230,11,1,3,-3,0,2020-09-11
2020-09-11 09:25:00,2020-09-12 09:25:00,24.0,233,8,2,230,5,2,0,3,0,2020-09-11
2020-09-11 09:55:00,2020-09-12 09:55:00,24.0,233,8,2,230,5,2,0,3,0,2020-09-11
2020-09-11 10:35:00,2020-09-11 18:35:00,8.0,233,8,1,230,11,1,0,-3,0,2020-09-11
2020-09-12 09:40:00,2020-09-13 09:40:00,24.0,233,3,1,230,3,1,0,0,0,2020-09-12
2020-09-12 12:50:00,2020-09-13 12:50:00,24.0,233,3,1,230,3,1,0,0,0,2020-09-12
2020-09-12 21:40:00,2020-09-13 21:40:00,24.0,233,3,1,230,3,1,0,0,0,2020-09-12
2020-09-14 02:00:00,2020-10-14 02:00:00,720.0,233,9,1,207,13,1,0,-4,0,2020-09-14
2020-09-14 08:00:00,2020-09-15 08:00:00,24.0,233,9,5,230,8,4,1,1,0,2020-09-14
2020-09-14 08:05:00,2020-09-15 08:05:00,24.0,233,9,5,230,8,4,1,1,0,2020-09-14
2020-09-14 08:35:00,2020-09-15 08:35:00,24.0,233,9,5,230,8,4,1,1,0,2020-09-14
2020-09-14 08:40:00,2020-09-15 08:40:00,24.0,233,9,5,230,8,4,1,1,0,2020-09-14
2020-09-14 08:55:00,2020-09-14 20:55:00,12.0,233,9,5,230,1,1,4,8,0,2020-09-14
2020-09-14 09:40:00,2020-09-15 09:40:00,24.0,233,9,3,230,8,3,0,1,0,2020-09-14
2020-09-14 09:45:00,2020-09-15 09:45:00,24.0,233,9,3,230,8,3,0,1,0,2020-09-14
2020-09-14 09:45:00,2020-09-15 09:45:00,24.0,233,9,3,230,8,3,0,1,0,2020-09-14
2020-09-15 08:00:00,2020-09-16 08:00:00,24.0,233,10,7,230,10,6,1,0,0,2020-09-15
2020-09-15 08:00:00,2020-09-16 08:00:00,24.0,233,10,7,230,10,6,1,0,0,2020-09-15
2020-09-15 08:05:00,2020-09-16 08:05:00,24.0,233,10,7,230,10,6,1,0,0,2020-09-15
2020-09-15 08:25:00,2020-09-16 08:25:00,24.0,233,10,7,230,10,6,1,0,0,2020-09-15
2020-09-15 08:35:00,2020-09-16 08:35:00,24.0,233,10,7,230,10,6,1,0,0,2020-09-15
2020-09-15 08:40:00,2020-09-16 08:40:00,24.0,233,10,7,230,10,6,1,0,0,2020-09-15
2020-09-15 08:45:00,2020-09-15 20:45:00,12.0,233,10,7,230,8,1,6,2,0,2020-09-15
2020-09-15 09:25:00,2020-09-16 09:25:00,24.0,233,10,3,230,10,3,0,0,0,2020-09-15
2020-09-15 09:35:00,2020-09-16 09:35:00,24.0,233,10,3,230,10,3,0,0,0,2020-09-15
2020-09-15 09:35:00,2020-09-16 09:35:00,24.0,233,10,3,230,10,3,0,0,0,2020-09-15
2020-09-16 08:00:00,2020-09-17 08:00:00,24.0,233,8,4,230,9,3,1,-1,0,2020-09-16
2020-09-16 08:05:00,2020-09-17 08:05:00,24.0,233,8,4,230,9,3,1,-1,0,2020-09-16
2020-09-16 08:35:00,2020-09-17 08:35:00,24.0,233,8,4,230,9,3,1,-1,0,2020-09-16
2020-09-16 08:50:00,2020-09-16 20:50:00,12.0,233,8,4,230,10,1,3,-2,0,2020-09-16
2020-09-16 09:25:00,2020-09-17 09:25:00,24.0,233,8,1,230,9,1,0,-1,0,2020-09-16
2020-09-16 10:00:00,2020-09-17 10:00:00,24.0,233,8,2,230,9,2,0,-1,0,2020-09-16
2020-09-16 10:45:00,2020-09-17 10:45:00,24.0,233,8,2,230,9,2,0,-1,0,2020-09-16
2020-09-16 19:30:00,2020-09-17 19:30:00,24.0,233,8,1,230,9,1,0,-1,0,2020-09-16
2020-09-17 00:40:00,2020-09-18 00:40:00,24.0,233,13,1,230,11,1,0,2,0,2020-09-17
2020-09-17 02:00:00,2020-10-17 02:00:00,720.0,233,13,1,207,7,1,0,6,0,2020-09-17
2020-09-17 08:00:00,2020-09-18 08:00:00,24.0,233,13,5,230,11,4,1,2,0,2020-09-17
2020-09-17 08:25:00,2020-09-18 08:25:00,24.0,233,13,5,230,11,4,1,2,0,2020-09-17
2020-09-17 08:30:00,2020-09-18 08:30:00,24.0,233,13,5,230,11,4,1,2,0,2020-09-17
2020-09-17 08:35:00,2020-09-18 08:35:00,24.0,233,13,5,230,11,4,1,2,0,2020-09-17
2020-09-17 08:45:00,2020-09-17 20:45:00,12.0,233,13,5,230,9,1,4,4,0,2020-09-17
2020-09-17 09:00:00,2020-09-18 09:00:00,24.0,233,13,5,230,11,5,0,2,0,2020-09-17
2020-09-17 09:10:00,2020-09-18 09:10:00,24.0,233,13,5,230,11,5,0,2,0,2020-09-17
2020-09-17 09:25:00,2020-09-18 09:25:00,24.0,233,13,5,230,11,5,0,2,0,2020-09-17
2020-09-17 09:25:00,2020-09-18 09:25:00,24.0,233,13,5,230,11,5,0,2,0,2020-09-17
2020-09-17 09:30:00,2020-09-18 09:30:00,24.0,233,13,5,230,11,5,0,2,0,2020-09-17
2020-09-17 13:45:00,2020-09-18 13:45:00,24.0,233,13,1,230,11,1,0,2,0,2020-09-17
2020-09-18 02:00:00,2020-10-18 02:00:00,720.0,233,10,1,207,1,1,0,9,0,2020-09-18
2020-09-18 08:00:00,2020-09-19 08:00:00,24.0,233,10,2,230,8,2,0,2,0,2020-09-18
2020-09-18 08:15:00,2020-09-19 08:15:00,24.0,233,10,2,230,8,2,0,2,0,2020-09-18
2020-09-18 09:25:00,2020-09-19 09:25:00,24.0,233,10,3,230,8,3,0,2,0,2020-09-18
2020-09-18 09:30:00,2020-09-19 09:30:00,24.0,233,10,3,230,8,3,0,2,0,2020-09-18
2020-09-18 09:45:00,2020-09-19 09:45:00,24.0,233,10,3,230,8,3,0,2,0,2020-09-18
2020-09-18 10:05:00,2020-09-19 10:05:00,24.0,233,10,2,230,8,2,0,2,0,2020-09-18
2020-09-18 10:20:00,2020-09-19 10:20:00,24.0,233,10,2,230,8,2,0,2,0,2020-09-18
2020-09-18 19:35:00,2020-09-19 19:35:00,24.0,233,10,1,230,8,1,0,2,0,2020-09-18
2020-09-18 22:30:00,2020-09-20 16:30:00,42.0,233,10,1,230,2,1,0,8,0,2020-09-18
2020-09-19 21:00:00,2020-09-20 21:00:00,24.0,233,1,1,230,2,1,0,-1,0,2020-09-19
2020-09-20 23:20:00,2020-09-26 23:20:00,144.0,233,1,1,230,8,1,0,-7,5,2020-09-20
2020-09-21 08:00:00,2020-09-22 08:00:00,24.0,233,8,4,230,7,3,1,1,4.2 %,2020-09-21
2020-09-21 08:05:00,2020-09-22 08:05:00,24.0,233,8,4,230,7,3,1,1,4.2 %,2020-09-21
2020-09-21 08:35:00,2020-09-22 08:35:00,24.0,233,8,4,230,7,3,1,1,4.2 %,2020-09-21
2020-09-21 08:50:00,2020-09-21 20:50:00,12.0,233,8,4,230,2,1,3,6,4.2 %,2020-09-21
2020-09-21 09:10:00,2020-09-22 09:10:00,24.0,233,8,3,230,7,3,0,1,4.2 %,2020-09-21
2020-09-21 09:10:00,2020-09-22 09:10:00,24.0,233,8,3,230,7,3,0,1,4.2 %,2020-09-21
2020-09-21 09:50:00,2020-09-22 09:50:00,24.0,233,8,3,230,7,3,0,1,4.2 %,2020-09-21
2020-09-21 12:15:00,2020-09-21 15:15:00,3.0,233,8,1,230,2,1,0,6,4.2 %,2020-09-21
2020-09-22 08:00:00,2020-09-23 08:00:00,24.0,233,10,4,230,10,3,1,0,0,2020-09-22
2020-09-22 08:35:00,2020-09-23 08:35:00,24.0,233,10,4,230,10,3,1,0,0,2020-09-22
2020-09-22 08:50:00,2020-09-22 21:50:00,13.0,233,10,4,230,7,1,3,3,0,2020-09-22
2020-09-22 08:55:00,2020-09-23 08:55:00,24.0,233,10,4,230,10,3,1,0,0,2020-09-22
2020-09-22 09:05:00,2020-09-23 09:05:00,24.0,233,10,5,230,10,5,0,0,0,2020-09-22
2020-09-22 09:10:00,2020-09-23 09:10:00,24.0,233,10,5,230,10,5,0,0,0,2020-09-22
2020-09-22 09:20:00,2020-09-23 09:20:00,24.0,233,10,5,230,10,5,0,0,0,2020-09-22
2020-09-22 09:30:00,2020-09-23 09:30:00,24.0,233,10,5,230,10,5,0,0,0,2020-09-22
2020-09-22 09:30:00,2020-09-23 09:30:00,24.0,233,10,5,230,10,5,0,0,0,2020-09-22
2020-09-22 10:50:00,2020-09-23 10:50:00,24.0,233,10,1,230,10,1,0,0,0,2020-09-22
2020-09-23 08:00:00,2020-09-24 08:00:00,24.0,233,8,3,230,9,2,1,-1,0,2020-09-23
2020-09-23 08:25:00,2020-09-24 08:25:00,24.0,233,8,3,230,9,2,1,-1,0,2020-09-23
2020-09-23 08:45:00,2020-09-23 21:45:00,13.0,233,8,3,230,10,1,2,-2,0,2020-09-23
2020-09-23 09:00:00,2020-09-24 09:00:00,24.0,233,8,3,230,9,3,0,-1,0,2020-09-23
2020-09-23 09:25:00,2020-09-24 09:25:00,24.0,233,8,3,230,9,3,0,-1,0,2020-09-23
2020-09-23 09:40:00,2020-09-24 09:40:00,24.0,233,8,3,230,9,3,0,-1,0,2020-09-23
2020-09-23 10:05:00,2020-09-24 10:05:00,24.0,233,8,1,230,9,1,0,-1,0,2020-09-23
2020-09-23 20:40:00,2020-09-24 20:40:00,24.0,233,8,1,230,9,1,0,-1,0,2020-09-23
2020-09-24 08:00:00,2020-09-25 08:00:00,24.0,233,9,4,230,9,3,1,0,0,2020-09-24
2020-09-24 08:20:00,2020-09-25 08:20:00,24.0,233,9,4,230,9,3,1,0,0,2020-09-24
2020-09-24 08:40:00,2020-09-25 08:40:00,24.0,233,9,4,230,9,3,1,0,0,2020-09-24
2020-09-24 08:55:00,2020-09-25 00:55:00,16.0,233,9,4,230,9,1,3,0,0,2020-09-24
2020-09-24 09:00:00,2020-09-25 09:00:00,24.0,233,9,4,230,9,4,0,0,0,2020-09-24
2020-09-24 09:25:00,2020-09-25 09:25:00,24.0,233,9,4,230,9,4,0,0,0,2020-09-24
2020-09-24 09:40:00,2020-09-25 09:40:00,24.0,233,9,4,230,9,4,0,0,0,2020-09-24
2020-09-24 09:55:00,2020-09-25 09:55:00,24.0,233,9,4,230,9,4,0,0,0,2020-09-24
2020-09-24 15:30:00,2020-09-24 17:30:00,2.0,233,9,1,230,9,1,0,0,0,2020-09-24
2020-09-25 08:55:00,2020-09-25 18:55:00,10.0,233,9,1,230,9,1,0,0,0,2020-09-25
2020-09-25 09:15:00,2020-09-26 09:15:00,24.0,233,9,1,230,8,1,0,1,0,2020-09-25
2020-09-25 10:05:00,2020-09-26 10:05:00,24.0,233,9,4,230,8,4,0,1,0,2020-09-25
2020-09-25 10:05:00,2020-09-26 10:05:00,24.0,233,9,4,230,8,4,0,1,0,2020-09-25
2020-09-25 10:15:00,2020-09-26 10:15:00,24.0,233,9,4,230,8,4,0,1,0,2020-09-25
2020-09-25 10:40:00,2020-09-26 10:40:00,24.0,233,9,4,230,8,4,0,1,0,2020-09-25
2020-09-25 11:55:00,2020-09-26 11:55:00,24.0,233,9,1,230,8,1,0,1,0,2020-09-25
2020-09-25 19:30:00,2020-09-27 20:30:00,49.0,233,9,1,230,3,1,0,6,0,2020-09-25
2020-09-25 22:00:00,2020-09-26 22:00:00,24.0,233,9,1,230,8,1,0,1,0,2020-09-25
2020-09-26 10:40:00,2020-09-27 10:40:00,24.0,233,3,1,230,3,1,0,0,0,2020-09-26
2020-09-26 15:40:00,2020-09-28 15:40:00,48.0,233,3,1,230,2,1,0,1,0,2020-09-26
2020-09-26 19:55:00,2020-09-27 19:55:00,24.0,233,3,1,230,3,1,0,0,0,2020-09-26
2020-09-28 08:45:00,2020-09-28 20:45:00,12.0,233,5,2,230,2,1,1,3,0,2020-09-28
2020-09-28 08:55:00,2020-09-29 08:55:00,24.0,233,5,2,230,5,1,1,0,0,2020-09-28
2020-09-28 09:10:00,2020-09-29 09:10:00,24.0,233,5,2,230,5,2,0,0,0,2020-09-28
2020-09-28 09:55:00,2020-09-29 09:55:00,24.0,233,5,2,230,5,2,0,0,0,2020-09-28
2020-09-28 10:15:00,2020-09-29 10:15:00,24.0,233,5,1,230,5,1,0,0,0,2020-09-28
2020-09-29 08:10:00,2020-09-30 08:10:00,24.0,233,12,3,230,12,2,1,0,0,2020-09-29
2020-09-29 08:55:00,2020-09-30 08:55:00,24.0,233,12,3,230,12,2,1,0,0,2020-09-29
2020-09-29 08:55:00,2020-09-29 19:55:00,11.0,233,12,3,230,5,1,2,7,0,2020-09-29
2020-09-29 09:10:00,2020-09-30 09:10:00,24.0,233,12,3,230,12,3,0,0,0,2020-09-29
2020-09-29 09:15:00,2020-09-30 09:15:00,24.0,233,12,3,230,12,3,0,0,0,2020-09-29
2020-09-29 09:20:00,2020-09-30 09:20:00,24.0,233,12,3,230,12,3,0,0,0,2020-09-29
2020-09-29 10:00:00,2020-09-30 10:00:00,24.0,233,12,4,230,12,4,0,0,0,2020-09-29
2020-09-29 10:00:00,2020-09-30 10:00:00,24.0,233,12,4,230,12,4,0,0,0,2020-09-29
2020-09-29 10:00:00,2020-09-30 10:00:00,24.0,233,12,4,230,12,4,0,0,0,2020-09-29
2020-09-29 10:10:00,2020-09-30 10:10:00,24.0,233,12,4,230,12,4,0,0,0,2020-09-29
2020-09-29 15:25:00,2020-09-30 15:25:00,24.0,233,12,1,230,12,1,0,0,0,2020-09-29
2020-09-29 18:20:00,2020-10-01 20:20:00,50.0,233,12,1,207,11,3,-2,1,0,2020-09-29
2020-09-30 08:30:00,2020-10-01 08:30:00,24.0,233,11,3,207,11,3,0,0,0,2020-09-30
2020-09-30 08:55:00,2020-10-01 08:55:00,24.0,233,11,3,207,11,3,0,0,0,2020-09-30
2020-09-30 08:55:00,2020-10-01 08:55:00,24.0,233,11,3,207,11,3,0,0,0,2020-09-30
2020-09-30 09:00:00,2020-09-30 21:00:00,12.0,233,11,3,230,12,1,2,-1,0,2020-09-30
2020-09-30 09:20:00,2020-10-01 09:20:00,24.0,233,11,3,207,11,2,1,0,0,2020-09-30
2020-09-30 09:30:00,2020-10-01 09:30:00,24.0,233,11,3,207,11,2,1,0,0,2020-09-30
2020-09-30 10:10:00,2020-10-01 10:10:00,24.0,233,11,1,207,11,1,0,0,0,2020-09-30
2020-09-30 12:40:00,2020-09-30 18:40:00,6.0,233,11,1,230,12,1,0,-1,0,2020-09-30
2020-09-30 19:50:00,2020-10-01 19:50:00,24.0,233,11,1,207,11,1,0,0,0,2020-09-30
2020-09-30 20:20:00,2020-10-01 20:20:00,24.0,233,11,1,207,11,3,-2,0,0,2020-09-30
2020-09-30 23:50:00,2020-10-03 23:50:00,72.0,233,11,1,207,8,2,-1,3,0,2020-09-30
2020-10-01 02:00:00,2020-11-01 01:00:00,743.0,198,13,1,157,3,1,0,10,0,2020-10-01
2020-10-01 08:25:00,2020-10-02 08:25:00,24.0,198,13,3,207,12,2,1,1,0,2020-10-01
2020-10-01 08:40:00,2020-10-02 08:40:00,24.0,198,13,3,207,12,2,1,1,0,2020-10-01
2020-10-01 08:45:00,2020-10-01 20:45:00,12.0,198,13,3,207,11,3,0,2,0,2020-10-01
2020-10-01 09:00:00,2020-10-02 09:00:00,24.0,198,13,3,207,12,3,0,1,0,2020-10-01
2020-10-01 09:35:00,2020-10-02 09:35:00,24.0,198,13,3,207,12,3,0,1,0,2020-10-01
2020-10-01 09:45:00,2020-10-02 09:45:00,24.0,198,13,3,207,12,3,0,1,0,2020-10-01
2020-10-01 10:00:00,2020-10-02 10:00:00,24.0,198,13,2,207,12,2,0,1,0,2020-10-01
2020-10-01 10:10:00,2020-10-02 10:10:00,24.0,198,13,2,207,12,2,0,1,0,2020-10-01
2020-10-01 11:10:00,2020-10-02 11:10:00,24.0,198,13,1,207,12,1,0,1,0,2020-10-01
2020-10-01 14:00:00,2020-10-02 14:00:00,24.0,198,13,1,207,12,1,0,1,0,2020-10-01
2020-10-01 20:20:00,2020-10-02 20:20:00,24.0,198,13,1,207,12,1,0,1,0,2020-10-01
2020-10-01 21:55:00,2020-10-02 21:55:00,24.0,198,13,1,207,12,1,0,1,0,2020-10-01
2020-10-02 08:55:00,2020-10-03 08:55:00,24.0,198,8,2,207,8,1,1,0,0,2020-10-02
2020-10-02 08:55:00,2020-10-02 22:55:00,14.0,198,8,2,207,12,1,1,-4,0,2020-10-02
2020-10-02 09:05:00,2020-10-03 09:05:00,24.0,198,8,2,207,8,2,0,0,0,2020-10-02
2020-10-02 09:25:00,2020-10-03 09:25:00,24.0,198,8,2,207,8,2,0,0,0,2020-10-02
2020-10-02 10:05:00,2020-10-03 10:05:00,24.0,198,8,2,207,8,2,0,0,0,2020-10-02
2020-10-02 10:35:00,2020-10-03 10:35:00,24.0,198,8,2,207,8,2,0,0,0,2020-10-02
2020-10-02 14:15:00,2020-10-03 14:15:00,24.0,198,8,1,207,8,1,0,0,0,2020-10-02
2020-10-02 23:55:00,2020-10-03 23:55:00,24.0,198,8,1,207,8,2,-1,0,0,2020-10-02
2020-10-03 01:25:00,2020-10-04 01:25:00,24.0,198,3,1,207,3,1,0,0,0,2020-10-03
2020-10-03 09:15:00,2020-10-04 09:15:00,24.0,198,3,1,207,3,1,0,0,0,2020-10-03
2020-10-03 23:50:00,2020-10-04 20:50:00,21.0,198,3,1,207,3,1,0,0,0,2020-10-03
2020-10-04 02:05:00,2020-10-05 02:05:00,24.0,198,2,1,207,6,1,0,-4,2,2020-10-04
2020-10-04 21:15:00,2020-10-05 21:15:00,24.0,198,2,1,207,6,1,0,-4,2,2020-10-04
2020-10-05 08:25:00,2020-10-06 08:25:00,24.0,198,11,4,207,7,3,1,4,5,2020-10-05
2020-10-05 08:35:00,2020-10-06 08:35:00,24.0,198,11,4,207,7,3,1,4,5,2020-10-05
2020-10-05 08:35:00,2020-10-06 08:35:00,24.0,198,11,4,207,7,3,1,4,5,2020-10-05
2020-10-05 08:50:00,2020-10-05 20:50:00,12.0,198,11,4,207,6,2,2,5,5,2020-10-05
2020-10-05 09:05:00,2020-10-06 09:05:00,24.0,198,11,2,207,7,2,0,4,5,2020-10-05
2020-10-05 09:10:00,2020-10-06 09:10:00,24.0,198,11,2,207,7,2,0,4,5,2020-10-05
2020-10-05 10:25:00,2020-10-06 10:25:00,24.0,198,11,2,207,7,1,1,4,5,2020-10-05
2020-10-05 10:30:00,2020-10-05 18:30:00,8.0,198,11,2,207,6,1,1,5,5,2020-10-05
2020-10-05 17:40:00,2020-10-05 19:40:00,2.0,198,11,1,207,6,1,0,5,5,2020-10-05
2020-10-05 19:00:00,2020-10-05 20:00:00,1.0,198,11,1,207,6,2,-1,5,5,2020-10-05
2020-10-05 22:35:00,2020-10-06 22:35:00,24.0,198,11,1,207,7,1,0,4,5,2020-10-05
2020-10-06 03:00:00,2020-10-07 02:00:00,23.0,198,9,1,207,10,2,-1,-1,0,2020-10-06
2020-10-06 08:30:00,2020-10-07 08:30:00,24.0,198,9,3,207,10,3,0,-1,0,2020-10-06
2020-10-06 08:50:00,2020-10-07 08:50:00,24.0,198,9,3,207,10,3,0,-1,0,2020-10-06
2020-10-06 08:50:00,2020-10-07 08:50:00,24.0,198,9,3,207,10,3,0,-1,0,2020-10-06
2020-10-06 09:00:00,2020-10-07 09:00:00,24.0,198,9,4,207,10,4,0,-1,0,2020-10-06
2020-10-06 09:05:00,2020-10-07 09:05:00,24.0,198,9,4,207,10,4,0,-1,0,2020-10-06
2020-10-06 09:10:00,2020-10-07 09:10:00,24.0,198,9,4,207,10,4,0,-1,0,2020-10-06
2020-10-06 09:10:00,2020-10-07 09:10:00,24.0,198,9,4,207,10,4,0,-1,0,2020-10-06
2020-10-06 22:35:00,2020-10-07 22:35:00,24.0,198,9,1,207,10,1,0,-1,0,2020-10-06
2020-10-07 08:40:00,2020-10-08 08:40:00,24.0,198,5,1,207,6,1,0,-1,0,2020-10-07
2020-10-07 09:15:00,2020-10-08 09:15:00,24.0,198,5,4,207,6,4,0,-1,0,2020-10-07
2020-10-07 09:25:00,2020-10-08 09:25:00,24.0,198,5,4,207,6,4,0,-1,0,2020-10-07
2020-10-07 09:35:00,2020-10-08 09:35:00,24.0,198,5,4,207,6,4,0,-1,0,2020-10-07
2020-10-07 09:40:00,2020-10-08 09:40:00,24.0,198,5,4,207,6,4,0,-1,0,2020-10-07
2020-10-08 01:45:00,2020-10-10 01:45:00,48.0,198,7,1,207,7,1,0,0,0,2020-10-08
2020-10-08 08:30:00,2020-10-09 08:30:00,24.0,198,7,2,207,6,1,1,1,0,2020-10-08
2020-10-08 08:55:00,2020-10-08 20:55:00,12.0,198,7,2,207,6,1,1,1,0,2020-10-08
2020-10-08 09:00:00,2020-10-09 09:00:00,24.0,198,7,3,207,6,3,0,1,0,2020-10-08
2020-10-08 09:30:00,2020-10-09 09:30:00,24.0,198,7,3,207,6,3,0,1,0,2020-10-08
2020-10-08 09:45:00,2020-10-09 09:45:00,24.0,198,7,3,207,6,3,0,1,0,2020-10-08
2020-10-08 10:00:00,2020-10-09 10:00:00,24.0,198,7,1,207,6,1,0,1,0,2020-10-08
2020-10-09 08:45:00,2020-10-09 20:45:00,12.0,198,7,2,207,6,1,1,1,0,2020-10-09
2020-10-09 08:50:00,2020-10-10 08:50:00,24.0,198,7,2,207,7,1,1,0,0,2020-10-09
2020-10-09 09:05:00,2020-10-10 09:05:00,24.0,198,7,3,207,7,3,0,0,0,2020-10-09
2020-10-09 09:25:00,2020-10-10 09:25:00,24.0,198,7,3,207,7,3,0,0,0,2020-10-09
2020-10-09 09:35:00,2020-10-10 09:35:00,24.0,198,7,3,207,7,3,0,0,0,2020-10-09
2020-10-09 10:05:00,2020-10-10 10:05:00,24.0,198,7,2,207,7,2,0,0,0,2020-10-09
2020-10-09 10:05:00,2020-10-10 10:05:00,24.0,198,7,2,207,7,2,0,0,0,2020-10-09
2020-10-10 09:00:00,2020-10-11 09:00:00,24.0,198,1,1,207,2,1,0,-1,0,2020-10-10
2020-10-12 07:00:00,2020-10-13 01:00:00,18.0,198,12,2,207,12,2,0,0,0,2020-10-12
2020-10-12 07:55:00,2020-10-13 07:55:00,24.0,198,12,2,207,12,1,1,0,0,2020-10-12
2020-10-12 08:10:00,2020-10-13 08:10:00,24.0,198,12,4,207,12,3,1,0,0,2020-10-12
2020-10-12 08:25:00,2020-10-13 08:25:00,24.0,198,12,4,207,12,3,1,0,0,2020-10-12
2020-10-12 08:40:00,2020-10-12 21:40:00,13.0,198,12,4,207,1,1,3,11,0,2020-10-12
2020-10-12 08:40:00,2020-10-13 08:40:00,24.0,198,12,4,207,12,3,1,0,0,2020-10-12
2020-10-12 09:20:00,2020-10-13 09:20:00,24.0,198,12,4,207,12,3,1,0,0,2020-10-12
2020-10-12 09:30:00,2020-10-13 09:30:00,24.0,198,12,4,207,12,3,1,0,0,2020-10-12
2020-10-12 09:35:00,2020-10-13 09:35:00,24.0,198,12,4,207,12,3,1,0,0,2020-10-12
2020-10-12 09:40:00,2020-10-13 01:40:00,16.0,198,12,4,207,12,2,2,0,0,2020-10-12
2020-10-12 10:00:00,2020-10-13 10:00:00,24.0,198,12,1,207,12,1,0,0,0,2020-10-12
2020-10-12 14:40:00,2020-10-13 14:40:00,24.0,198,12,1,207,12,1,0,0,0,2020-10-12
2020-10-13 07:10:00,2020-10-14 07:10:00,24.0,198,11,1,207,13,1,0,-2,0,2020-10-13
2020-10-13 08:20:00,2020-10-14 08:20:00,24.0,198,11,5,207,13,5,0,-2,0,2020-10-13
2020-10-13 08:25:00,2020-10-14 08:25:00,24.0,198,11,5,207,13,5,0,-2,0,2020-10-13
2020-10-13 08:40:00,2020-10-14 08:40:00,24.0,198,11,5,207,13,5,0,-2,0,2020-10-13
2020-10-13 08:50:00,2020-10-14 08:50:00,24.0,198,11,5,207,13,5,0,-2,0,2020-10-13
2020-10-13 08:55:00,2020-10-14 08:55:00,24.0,198,11,5,207,13,5,0,-2,0,2020-10-13
2020-10-13 09:25:00,2020-10-14 09:25:00,24.0,198,11,2,207,13,2,0,-2,0,2020-10-13
2020-10-13 09:30:00,2020-10-14 09:30:00,24.0,198,11,2,207,13,2,0,-2,0,2020-10-13
2020-10-13 10:00:00,2020-10-14 10:00:00,24.0,198,11,1,207,13,1,0,-2,0,2020-10-13
2020-10-13 14:40:00,2020-10-13 18:40:00,4.0,198,11,1,207,12,1,0,-1,0,2020-10-13
2020-10-13 18:45:00,2020-10-14 18:45:00,24.0,198,11,1,207,13,1,0,-2,0,2020-10-13
2020-10-14 02:00:00,2020-11-14 01:00:00,743.0,198,10,1,157,8,1,0,2,0,2020-10-14
2020-10-14 08:50:00,2020-10-14 21:50:00,13.0,198,10,1,207,13,1,0,-3,0,2020-10-14
2020-10-14 09:20:00,2020-10-15 09:20:00,24.0,198,10,3,207,9,3,0,1,0,2020-10-14
2020-10-14 09:30:00,2020-10-15 09:30:00,24.0,198,10,3,207,9,3,0,1,0,2020-10-14
2020-10-14 09:50:00,2020-10-15 09:50:00,24.0,198,10,3,207,9,3,0,1,0,2020-10-14
2020-10-14 10:00:00,2020-10-15 10:00:00,24.0,198,10,3,207,9,2,1,1,0,2020-10-14
2020-10-14 10:10:00,2020-10-14 14:10:00,4.0,198,10,3,207,13,1,2,-3,0,2020-10-14
2020-10-14 10:30:00,2020-10-15 10:30:00,24.0,198,10,3,207,9,2,1,1,0,2020-10-14
2020-10-14 14:30:00,2020-10-15 14:30:00,24.0,198,10,1,207,9,1,0,1,0,2020-10-14
2020-10-14 20:05:00,2020-10-15 20:05:00,24.0,198,10,1,207,9,2,-1,1,0,2020-10-14
2020-10-15 02:00:00,2020-11-15 01:00:00,743.0,198,10,1,157,2,1,0,8,0,2020-10-15
2020-10-15 08:35:00,2020-10-16 08:35:00,24.0,198,10,3,207,8,2,1,2,0,2020-10-15
2020-10-15 08:35:00,2020-10-16 08:35:00,24.0,198,10,3,207,8,2,1,2,0,2020-10-15
2020-10-15 08:50:00,2020-10-15 20:50:00,12.0,198,10,3,207,9,2,1,1,0,2020-10-15
2020-10-15 09:20:00,2020-10-16 09:20:00,24.0,198,10,4,207,8,4,0,2,0,2020-10-15
2020-10-15 09:25:00,2020-10-16 09:25:00,24.0,198,10,4,207,8,4,0,2,0,2020-10-15
2020-10-15 09:35:00,2020-10-16 09:35:00,24.0,198,10,4,207,8,4,0,2,0,2020-10-15
2020-10-15 09:50:00,2020-10-16 09:50:00,24.0,198,10,4,207,8,4,0,2,0,2020-10-15
2020-10-15 18:40:00,2020-10-15 19:40:00,1.0,198,10,1,207,9,1,0,1,0,2020-10-15
2020-10-15 19:45:00,2020-10-20 16:45:00,117.0,198,10,1,207,7,1,0,3,0,2020-10-15
2020-10-16 08:50:00,2020-10-16 20:50:00,12.0,198,8,1,207,8,1,0,0,0,2020-10-16
2020-10-16 09:05:00,2020-10-17 09:05:00,24.0,198,8,4,207,7,4,0,1,0,2020-10-16
2020-10-16 09:15:00,2020-10-17 09:15:00,24.0,198,8,4,207,7,4,0,1,0,2020-10-16
2020-10-16 09:25:00,2020-10-17 09:25:00,24.0,198,8,4,207,7,4,0,1,0,2020-10-16
2020-10-16 09:55:00,2020-10-17 09:55:00,24.0,198,8,4,207,7,4,0,1,0,2020-10-16
2020-10-16 10:10:00,2020-10-17 10:10:00,24.0,198,8,1,207,7,1,0,1,0,2020-10-16
2020-10-16 14:50:00,2020-10-16 16:50:00,2.0,198,8,1,207,8,1,0,0,0,2020-10-16
2020-10-16 21:35:00,2020-10-17 21:35:00,24.0,198,8,1,207,7,1,0,1,0,2020-10-16
2020-10-17 02:00:00,2020-11-17 01:00:00,743.0,198,1,1,157,7,1,0,-6,0,2020-10-17
2020-10-19 02:00:00,2020-11-19 01:00:00,743.0,198,9,1,157,6,1,0,3,0,2020-10-19
2020-10-19 05:45:00,2020-10-20 04:45:00,23.0,198,9,1,207,7,1,0,2,0,2020-10-19
2020-10-19 08:10:00,2020-10-20 08:10:00,24.0,198,9,2,207,7,1,1,2,0,2020-10-19
2020-10-19 08:45:00,2020-10-19 20:45:00,12.0,198,9,2,207,2,1,1,7,0,2020-10-19
2020-10-19 09:00:00,2020-10-20 09:00:00,24.0,198,9,5,207,7,4,1,2,0,2020-10-19
2020-10-19 09:05:00,2020-10-20 09:05:00,24.0,198,9,5,207,7,4,1,2,0,2020-10-19
2020-10-19 09:25:00,2020-10-19 18:25:00,9.0,198,9,5,207,2,1,4,7,0,2020-10-19
2020-10-19 09:35:00,2020-10-20 09:35:00,24.0,198,9,5,207,7,4,1,2,0,2020-10-19
2020-10-19 09:55:00,2020-10-20 09:55:00,24.0,198,9,5,207,7,4,1,2,0,2020-10-19
2020-10-20 08:25:00,2020-10-21 08:25:00,24.0,198,10,4,207,11,4,0,-1,0,2020-10-20
2020-10-20 08:25:00,2020-10-21 08:25:00,24.0,198,10,4,207,11,4,0,-1,0,2020-10-20
2020-10-20 08:30:00,2020-10-21 08:30:00,24.0,198,10,4,207,11,4,0,-1,0,2020-10-20
2020-10-20 08:50:00,2020-10-21 08:50:00,24.0,198,10,4,207,11,4,0,-1,0,2020-10-20
2020-10-20 09:10:00,2020-10-21 09:10:00,24.0,198,10,2,207,11,2,0,-1,0,2020-10-20
2020-10-20 09:20:00,2020-10-21 09:20:00,24.0,198,10,2,207,11,2,0,-1,0,2020-10-20
2020-10-20 10:00:00,2020-10-21 10:00:00,24.0,198,10,2,207,11,2,0,-1,0,2020-10-20
2020-10-20 10:05:00,2020-10-21 10:05:00,24.0,198,10,2,207,11,2,0,-1,0,2020-10-20
2020-10-20 11:30:00,2020-10-21 11:30:00,24.0,198,10,1,207,11,1,0,-1,0,2020-10-20
2020-10-20 14:40:00,2020-10-21 14:40:00,24.0,198,10,1,207,11,1,0,-1,0,2020-10-20
2020-10-21 08:20:00,2020-10-22 08:20:00,24.0,198,9,5,207,8,4,1,1,0,2020-10-21
2020-10-21 08:30:00,2020-10-22 08:30:00,24.0,198,9,5,207,8,4,1,1,0,2020-10-21
2020-10-21 08:30:00,2020-10-22 08:30:00,24.0,198,9,5,207,8,4,1,1,0,2020-10-21
2020-10-21 08:35:00,2020-10-22 08:35:00,24.0,198,9,5,207,8,4,1,1,0,2020-10-21
2020-10-21 08:45:00,2020-10-21 20:45:00,12.0,198,9,5,207,11,1,4,-2,0,2020-10-21
2020-10-21 09:00:00,2020-10-22 09:00:00,24.0,198,9,3,207,8,3,0,1,0,2020-10-21
2020-10-21 09:05:00,2020-10-22 09:05:00,24.0,198,9,3,207,8,3,0,1,0,2020-10-21
2020-10-21 09:55:00,2020-10-22 09:55:00,24.0,198,9,3,207,8,3,0,1,0,2020-10-21
2020-10-21 10:45:00,2020-10-22 10:45:00,24.0,198,9,1,207,8,1,0,1,0,2020-10-21
2020-10-22 08:25:00,2020-10-23 08:25:00,24.0,198,8,3,207,8,3,0,0,0,2020-10-22
2020-10-22 08:25:00,2020-10-23 08:25:00,24.0,198,8,3,207,8,3,0,0,0,2020-10-22
2020-10-22 08:35:00,2020-10-23 08:35:00,24.0,198,8,3,207,8,3,0,0,0,2020-10-22
2020-10-22 09:20:00,2020-10-23 09:20:00,24.0,198,8,4,207,8,4,0,0,0,2020-10-22
2020-10-22 09:20:00,2020-10-23 09:20:00,24.0,198,8,4,207,8,4,0,0,0,2020-10-22
2020-10-22 09:40:00,2020-10-23 09:40:00,24.0,198,8,4,207,8,4,0,0,0,2020-10-22
2020-10-22 09:55:00,2020-10-23 09:55:00,24.0,198,8,4,207,8,4,0,0,0,2020-10-22
2020-10-22 10:45:00,2020-10-23 10:45:00,24.0,198,8,1,207,8,1,0,0,0,2020-10-22
2020-10-23 09:00:00,2020-10-24 09:00:00,24.0,198,7,4,207,7,4,0,0,0,2020-10-23
2020-10-23 09:25:00,2020-10-24 09:25:00,24.0,198,7,4,207,7,4,0,0,0,2020-10-23
2020-10-23 09:35:00,2020-10-24 09:35:00,24.0,198,7,4,207,7,4,0,0,0,2020-10-23
2020-10-23 09:55:00,2020-10-24 09:55:00,24.0,198,7,4,207,7,4,0,0,0,2020-10-23
2020-10-23 10:25:00,2020-10-24 10:25:00,24.0,198,7,2,207,7,2,0,0,0,2020-10-23
2020-10-23 10:30:00,2020-10-24 10:30:00,24.0,198,7,2,207,7,2,0,0,0,2020-10-23
2020-10-23 12:55:00,2020-10-24 12:55:00,24.0,198,7,1,207,7,1,0,0,0,2020-10-23
2020-10-26 07:10:00,2020-10-27 07:10:00,24.0,198,9,3,207,9,3,0,0,0,2020-10-26
2020-10-26 07:30:00,2020-10-27 07:30:00,24.0,198,9,3,207,9,3,0,0,0,2020-10-26
2020-10-26 07:45:00,2020-10-27 07:45:00,24.0,198,9,3,207,9,3,0,0,0,2020-10-26
2020-10-26 08:00:00,2020-10-27 08:00:00,24.0,198,9,4,207,9,4,0,0,0,2020-10-26
2020-10-26 08:15:00,2020-10-27 08:15:00,24.0,198,9,4,207,9,4,0,0,0,2020-10-26
2020-10-26 08:20:00,2020-10-27 08:20:00,24.0,198,9,4,207,9,4,0,0,0,2020-10-26
2020-10-26 08:30:00,2020-10-27 08:30:00,24.0,198,9,4,207,9,4,0,0,0,2020-10-26
2020-10-26 09:30:00,2020-10-27 09:30:00,24.0,198,9,2,207,9,2,0,0,0,2020-10-26
2020-10-26 09:50:00,2020-10-27 09:50:00,24.0,198,9,2,207,9,2,0,0,0,2020-10-26
2020-10-27 07:10:00,2020-10-28 07:10:00,24.0,198,6,2,207,7,2,0,-1,0,2020-10-27
2020-10-27 07:30:00,2020-10-28 07:30:00,24.0,198,6,2,207,7,2,0,-1,0,2020-10-27
2020-10-27 08:20:00,2020-10-28 08:20:00,24.0,198,6,3,207,7,3,0,-1,0,2020-10-27
2020-10-27 08:20:00,2020-10-28 08:20:00,24.0,198,6,3,207,7,3,0,-1,0,2020-10-27
2020-10-27 08:30:00,2020-10-28 08:30:00,24.0,198,6,3,207,7,3,0,-1,0,2020-10-27
2020-10-27 10:25:00,2020-10-28 10:25:00,24.0,198,6,1,207,7,1,0,-1,0,2020-10-27
2020-10-28 07:40:00,2020-10-29 07:40:00,24.0,198,7,2,207,8,1,1,-1,0,2020-10-28
2020-10-28 07:55:00,2020-10-28 19:55:00,12.0,198,7,2,207,7,1,1,0,0,2020-10-28
2020-10-28 08:00:00,2020-10-29 08:00:00,24.0,198,7,4,207,8,4,0,-1,0,2020-10-28
2020-10-28 08:00:00,2020-10-29 08:00:00,24.0,198,7,4,207,8,4,0,-1,0,2020-10-28
2020-10-28 08:25:00,2020-10-29 08:25:00,24.0,198,7,4,207,8,4,0,-1,0,2020-10-28
2020-10-28 08:40:00,2020-10-29 08:40:00,24.0,198,7,4,207,8,4,0,-1,0,2020-10-28
2020-10-28 22:40:00,2020-10-29 22:40:00,24.0,198,7,1,207,8,2,-1,-1,0,2020-10-28
2020-10-29 07:50:00,2020-10-30 07:50:00,24.0,198,7,1,207,5,1,0,2,0,2020-10-29
2020-10-29 08:00:00,2020-10-30 08:00:00,24.0,198,7,3,207,5,3,0,2,0,2020-10-29
2020-10-29 08:25:00,2020-10-30 08:25:00,24.0,198,7,3,207,5,3,0,2,0,2020-10-29
2020-10-29 08:30:00,2020-10-30 08:30:00,24.0,198,7,3,207,5,3,0,2,0,2020-10-29
2020-10-29 09:45:00,2020-10-30 09:45:00,24.0,198,7,1,207,5,1,0,2,0,2020-10-29
2020-10-29 18:50:00,2020-10-29 21:50:00,3.0,198,7,1,207,8,1,0,-1,0,2020-10-29
2020-10-29 21:55:00,2020-10-29 22:55:00,1.0,198,7,1,207,8,2,-1,-1,0,2020-10-29
2020-10-30 08:05:00,2020-10-31 08:05:00,24.0,198,6,3,207,6,3,0,0,0,2020-10-30
2020-10-30 08:20:00,2020-10-31 08:20:00,24.0,198,6,3,207,6,3,0,0,0,2020-10-30
2020-10-30 08:25:00,2020-10-31 08:25:00,24.0,198,6,3,207,6,3,0,0,0,2020-10-30
2020-10-30 14:20:00,2020-10-31 14:20:00,24.0,198,6,1,207,6,1,0,0,0,2020-10-30
2020-10-30 19:10:00,2020-10-31 00:10:00,5.0,198,6,1,207,6,1,0,0,0,2020-10-30
2020-10-30 20:20:00,2020-10-31 20:20:00,24.0,198,6,1,207,6,1,0,0,0,2020-10-30
2020-10-31 08:15:00,2020-11-01 08:15:00,24.0,198,2,1,157,3,1,0,-1,5,2020-10-31
2020-10-31 20:55:00,2020-11-01 20:55:00,24.0,198,2,1,157,3,1,0,-1,5,2020-10-31
2020-11-01 16:45:00,2020-11-05 13:45:00,93.0,157,2,1,157,7,2,-1,-5,0,2020-11-01
2020-11-01 20:30:00,2020-11-02 20:30:00,24.0,157,2,1,157,3,1,0,-1,0,2020-11-01
2020-11-02 06:50:00,2020-11-03 06:50:00,24.0,157,10,1,157,8,1,0,2,0,2020-11-02
2020-11-02 08:00:00,2020-11-02 17:00:00,9.0,157,10,6,157,3,1,5,7,0,2020-11-02
2020-11-02 08:05:00,2020-11-02 14:05:00,6.0,157,10,6,157,3,1,5,7,0,2020-11-02
2020-11-02 08:20:00,2020-11-03 08:20:00,24.0,157,10,6,157,8,4,2,2,0,2020-11-02
2020-11-02 08:20:00,2020-11-03 08:20:00,24.0,157,10,6,157,8,4,2,2,0,2020-11-02
2020-11-02 08:30:00,2020-11-03 08:30:00,24.0,157,10,6,157,8,4,2,2,0,2020-11-02
2020-11-02 08:30:00,2020-11-03 08:30:00,24.0,157,10,6,157,8,4,2,2,0,2020-11-02
2020-11-02 09:00:00,2020-11-03 09:00:00,24.0,157,10,1,157,8,1,0,2,0,2020-11-02
2020-11-02 10:25:00,2020-11-03 10:25:00,24.0,157,10,1,157,8,1,0,2,0,2020-11-02
2020-11-02 19:50:00,2020-11-03 19:50:00,24.0,157,10,1,157,8,1,0,2,0,2020-11-02
2020-11-03 06:55:00,2020-11-04 06:55:00,24.0,157,8,1,157,9,1,0,-1,0,2020-11-03
2020-11-03 07:35:00,2020-11-04 07:35:00,24.0,157,8,3,157,9,3,0,-1,0,2020-11-03
2020-11-03 07:40:00,2020-11-04 07:40:00,24.0,157,8,3,157,9,3,0,-1,0,2020-11-03
2020-11-03 07:50:00,2020-11-04 07:50:00,24.0,157,8,3,157,9,3,0,-1,0,2020-11-03
2020-11-03 08:30:00,2020-11-04 08:30:00,24.0,157,8,1,157,9,1,0,-1,0,2020-11-03
2020-11-03 10:15:00,2020-11-04 10:15:00,24.0,157,8,2,157,9,2,0,-1,0,2020-11-03
2020-11-03 10:15:00,2020-11-04 10:15:00,24.0,157,8,2,157,9,2,0,-1,0,2020-11-03
2020-11-03 18:55:00,2020-11-04 00:55:00,6.0,157,8,1,157,9,1,0,-1,0,2020-11-03
2020-11-04 07:35:00,2020-11-05 07:35:00,24.0,157,5,3,157,7,2,1,-2,0,2020-11-04
2020-11-04 07:50:00,2020-11-04 20:50:00,13.0,157,5,3,157,9,1,2,-4,0,2020-11-04
2020-11-04 07:50:00,2020-11-05 07:50:00,24.0,157,5,3,157,7,2,1,-2,0,2020-11-04
2020-11-04 08:20:00,2020-11-05 08:20:00,24.0,157,5,1,157,7,1,0,-2,0,2020-11-04
2020-11-04 09:00:00,2020-11-05 09:00:00,24.0,157,5,1,157,7,1,0,-2,0,2020-11-04
2020-11-05 07:35:00,2020-11-06 07:35:00,24.0,157,9,3,157,7,3,0,2,0,2020-11-05
2020-11-05 07:45:00,2020-11-06 07:45:00,24.0,157,9,3,157,7,3,0,2,0,2020-11-05
2020-11-05 07:55:00,2020-11-06 07:55:00,24.0,157,9,3,157,7,3,0,2,0,2020-11-05
2020-11-05 08:20:00,2020-11-06 08:20:00,24.0,157,9,3,157,7,3,0,2,0,2020-11-05
2020-11-05 08:20:00,2020-11-06 08:20:00,24.0,157,9,3,157,7,3,0,2,0,2020-11-05
2020-11-05 08:30:00,2020-11-06 08:30:00,24.0,157,9,3,157,7,3,0,2,0,2020-11-05
2020-11-05 09:05:00,2020-11-05 13:05:00,4.0,157,9,2,157,7,2,0,2,0,2020-11-05
2020-11-05 09:45:00,2020-11-05 17:45:00,8.0,157,9,2,157,7,1,1,2,0,2020-11-05
2020-11-05 10:00:00,2020-11-06 10:00:00,24.0,157,9,1,157,7,1,0,2,0,2020-11-05
2020-11-06 08:00:00,2020-11-07 08:00:00,24.0,157,7,6,157,7,6,0,0,5,2020-11-06
2020-11-06 08:10:00,2020-11-07 08:10:00,24.0,157,7,6,157,7,6,0,0,5,2020-11-06
2020-11-06 08:20:00,2020-11-07 08:20:00,24.0,157,7,6,157,7,6,0,0,5,2020-11-06
2020-11-06 08:25:00,2020-11-07 08:25:00,24.0,157,7,6,157,7,6,0,0,5,2020-11-06
2020-11-06 08:35:00,2020-11-07 08:35:00,24.0,157,7,6,157,7,6,0,0,5,2020-11-06
2020-11-06 08:55:00,2020-11-07 08:55:00,24.0,157,7,6,157,7,6,0,0,5,2020-11-06
2020-11-06 09:10:00,2020-11-07 09:10:00,24.0,157,7,1,157,7,1,0,0,5,2020-11-06
2020-11-07 01:00:00,2020-11-08 06:00:00,29.0,157,3,1,157,3,1,0,0,0,2020-11-07
2020-11-07 08:15:00,2020-11-08 08:15:00,24.0,157,3,1,157,3,1,0,0,0,2020-11-07
2020-11-07 14:05:00,2020-11-08 14:05:00,24.0,157,3,1,157,3,1,0,0,0,2020-11-07
2020-11-08 22:55:00,2020-11-09 22:55:00,24.0,157,1,1,157,3,1,0,-2,0,2020-11-08
2020-11-09 07:00:00,2020-11-10 07:00:00,24.0,157,5,4,157,3,2,2,2,0,2020-11-09
2020-11-09 07:20:00,2020-11-10 07:20:00,24.0,157,5,4,157,3,2,2,2,0,2020-11-09
2020-11-09 07:50:00,2020-11-09 19:50:00,12.0,157,5,4,157,3,1,3,2,0,2020-11-09
2020-11-09 07:50:00,2020-11-09 13:50:00,6.0,157,5,4,157,3,1,3,2,0,2020-11-09
2020-11-09 08:55:00,2020-11-10 08:55:00,24.0,157,5,1,157,3,1,0,2,0,2020-11-09
2020-11-10 07:50:00,2020-11-11 07:50:00,24.0,157,6,1,157,7,1,0,-1,0,2020-11-10
2020-11-10 08:00:00,2020-11-11 08:00:00,24.0,157,6,3,157,7,3,0,-1,0,2020-11-10
2020-11-10 08:15:00,2020-11-11 08:15:00,24.0,157,6,3,157,7,3,0,-1,0,2020-11-10
2020-11-10 08:15:00,2020-11-11 08:15:00,24.0,157,6,3,157,7,3,0,-1,0,2020-11-10
2020-11-10 09:10:00,2020-11-11 09:10:00,24.0,157,6,1,157,7,1,0,-1,0,2020-11-10
2020-11-10 10:40:00,2020-11-11 10:40:00,24.0,157,6,1,157,7,1,0,-1,0,2020-11-10
2020-11-11 07:40:00,2020-11-12 07:40:00,24.0,157,10,3,157,10,3,0,0,<1 %,2020-11-11
2020-11-11 07:50:00,2020-11-12 07:50:00,24.0,157,10,3,157,10,3,0,0,<1 %,2020-11-11
2020-11-11 07:50:00,2020-11-12 07:50:00,24.0,157,10,3,157,10,3,0,0,<1 %,2020-11-11
2020-11-11 08:00:00,2020-11-12 08:00:00,24.0,157,10,3,157,10,2,1,0,<1 %,2020-11-11
2020-11-11 08:35:00,2020-11-12 08:35:00,24.0,157,10,3,157,10,2,1,0,<1 %,2020-11-11
2020-11-11 08:50:00,2020-11-11 20:50:00,12.0,157,10,3,157,7,1,2,3,<1 %,2020-11-11
2020-11-11 09:00:00,2020-11-12 09:00:00,24.0,157,10,3,157,10,3,0,0,<1 %,2020-11-11
2020-11-11 09:15:00,2020-11-12 09:15:00,24.0,157,10,3,157,10,3,0,0,<1 %,2020-11-11
2020-11-11 09:50:00,2020-11-12 09:50:00,24.0,157,10,3,157,10,3,0,0,<1 %,2020-11-11
2020-11-11 13:10:00,2020-11-12 13:10:00,24.0,157,10,1,157,10,1,0,0,<1 %,2020-11-11
2020-11-12 07:55:00,2020-11-13 07:55:00,24.0,157,4,1,157,3,1,0,1,0,2020-11-12
2020-11-12 08:50:00,2020-11-12 19:50:00,11.0,157,4,1,157,10,1,0,-6,0,2020-11-12
2020-11-12 09:50:00,2020-11-13 09:50:00,24.0,157,4,1,157,3,1,0,1,0,2020-11-12
2020-11-12 10:05:00,2020-11-13 10:05:00,24.0,157,4,1,157,3,1,0,1,0,2020-11-12
2020-11-13 07:40:00,2020-11-14 07:40:00,24.0,157,7,1,157,8,1,0,-1,0,2020-11-13
2020-11-13 08:10:00,2020-11-14 08:10:00,24.0,157,7,3,157,8,3,0,-1,0,2020-11-13
2020-11-13 08:35:00,2020-11-14 08:35:00,24.0,157,7,3,157,8,3,0,-1,0,2020-11-13
2020-11-13 08:40:00,2020-11-14 08:40:00,24.0,157,7,3,157,8,3,0,-1,0,2020-11-13
2020-11-13 09:25:00,2020-11-14 09:25:00,24.0,157,7,1,157,8,1,0,-1,0,2020-11-13
2020-11-13 16:10:00,2020-11-15 16:10:00,48.0,157,7,1,157,2,1,0,5,0,2020-11-13
2020-11-13 23:55:00,2020-11-14 23:55:00,24.0,157,7,1,157,8,1,0,-1,0,2020-11-13
2020-11-14 01:00:00,2020-11-16 06:00:00,53.0,157,2,1,157,2,1,0,0,0,2020-11-14
2020-11-14 10:20:00,2020-11-14 15:20:00,5.0,157,2,1,157,8,1,0,-6,0,2020-11-14
2020-11-16 07:00:00,2020-11-17 07:00:00,24.0,157,7,2,157,7,2,0,0,0,2020-11-16
2020-11-16 07:35:00,2020-11-17 07:35:00,24.0,157,7,2,157,7,2,0,0,0,2020-11-16
2020-11-16 08:00:00,2020-11-17 00:00:00,16.0,157,7,4,157,7,1,3,0,0,2020-11-16
2020-11-16 08:15:00,2020-11-16 17:15:00,9.0,157,7,4,157,2,1,3,5,0,2020-11-16
2020-11-16 08:40:00,2020-11-17 08:40:00,24.0,157,7,4,157,7,2,2,0,0,2020-11-16
2020-11-16 08:55:00,2020-11-17 08:55:00,24.0,157,7,4,157,7,2,2,0,0,2020-11-16
2020-11-16 09:10:00,2020-11-17 09:10:00,24.0,157,7,1,157,7,1,0,0,0,2020-11-16
2020-11-17 07:00:00,2020-11-18 07:00:00,24.0,157,9,3,157,10,3,0,-1,0,2020-11-17
2020-11-17 07:25:00,2020-11-18 07:25:00,24.0,157,9,3,157,10,3,0,-1,0,2020-11-17
2020-11-17 07:30:00,2020-11-18 07:30:00,24.0,157,9,3,157,10,3,0,-1,0,2020-11-17
2020-11-17 08:05:00,2020-11-18 08:05:00,24.0,157,9,4,157,10,4,0,-1,0,2020-11-17
2020-11-17 08:20:00,2020-11-18 08:20:00,24.0,157,9,4,157,10,4,0,-1,0,2020-11-17
2020-11-17 08:20:00,2020-11-18 08:20:00,24.0,157,9,4,157,10,4,0,-1,0,2020-11-17
2020-11-17 08:45:00,2020-11-18 08:45:00,24.0,157,9,4,157,10,4,0,-1,0,2020-11-17
2020-11-17 09:30:00,2020-11-18 09:30:00,24.0,157,9,2,157,10,2,0,-1,0,2020-11-17
2020-11-17 09:45:00,2020-11-18 09:45:00,24.0,157,9,2,157,10,2,0,-1,0,2020-11-17
2020-11-18 07:40:00,2020-11-18 18:40:00,11.0,157,7,1,157,10,1,0,-3,0,2020-11-18
2020-11-18 08:25:00,2020-11-19 08:25:00,24.0,157,7,3,157,6,3,0,1,0,2020-11-18
2020-11-18 08:35:00,2020-11-19 08:35:00,24.0,157,7,3,157,6,3,0,1,0,2020-11-18
2020-11-18 08:50:00,2020-11-19 08:50:00,24.0,157,7,3,157,6,3,0,1,0,2020-11-18
2020-11-18 09:20:00,2020-11-19 09:20:00,24.0,157,7,2,157,6,2,0,1,0,2020-11-18
2020-11-18 09:35:00,2020-11-19 09:35:00,24.0,157,7,2,157,6,2,0,1,0,2020-11-18
2020-11-18 16:30:00,2020-11-20 16:30:00,48.0,157,7,1,157,7,1,0,0,0,2020-11-18
2020-11-19 01:00:00,2020-12-19 01:00:00,720.0,157,7,1,172,11,1,0,-4,0,2020-11-19
2020-11-19 07:40:00,2020-11-20 07:40:00,24.0,157,7,2,157,7,2,0,0,0,2020-11-19
2020-11-19 07:55:00,2020-11-20 07:55:00,24.0,157,7,2,157,7,2,0,0,0,2020-11-19
2020-11-19 08:10:00,2020-11-20 08:10:00,24.0,157,7,2,157,7,2,0,0,0,2020-11-19
2020-11-19 08:30:00,2020-11-20 08:30:00,24.0,157,7,2,157,7,2,0,0,0,2020-11-19
2020-11-19 09:05:00,2020-11-20 09:05:00,24.0,157,7,2,157,7,2,0,0,0,2020-11-19
2020-11-19 09:35:00,2020-11-20 09:35:00,24.0,157,7,2,157,7,2,0,0,0,2020-11-19
2020-11-20 01:00:00,2020-11-22 06:00:00,53.0,157,7,2,157,4,1,1,3,0,2020-11-20
2020-11-20 01:00:00,2020-11-21 06:00:00,29.0,157,7,2,157,6,1,1,1,0,2020-11-20
2020-11-20 08:05:00,2020-11-21 08:05:00,24.0,157,7,4,157,6,4,0,1,0,2020-11-20
2020-11-20 08:10:00,2020-11-21 08:10:00,24.0,157,7,4,157,6,4,0,1,0,2020-11-20
2020-11-20 08:25:00,2020-11-21 08:25:00,24.0,157,7,4,157,6,4,0,1,0,2020-11-20
2020-11-20 08:55:00,2020-11-21 08:55:00,24.0,157,7,4,157,6,4,0,1,0,2020-11-20
2020-11-20 20:00:00,2020-11-21 20:00:00,24.0,157,7,1,157,6,1,0,1,0,2020-11-20
2020-11-21 08:25:00,2020-11-22 08:25:00,24.0,157,3,1,157,4,1,0,-1,0,2020-11-21
2020-11-21 11:25:00,2020-11-22 11:25:00,24.0,157,3,1,157,4,1,0,-1,0,2020-11-21
2020-11-21 17:55:00,2020-11-22 17:55:00,24.0,157,3,1,157,4,1,0,-1,0,2020-11-21
2020-11-23 01:00:00,2020-11-25 06:00:00,53.0,157,6,1,157,6,1,0,0,12.9 %,2020-11-23
2020-11-23 07:05:00,2020-11-24 07:05:00,24.0,157,6,2,157,4,1,1,2,12.9 %,2020-11-23
2020-11-23 07:50:00,2020-11-23 20:50:00,13.0,157,6,2,157,2,1,1,4,12.9 %,2020-11-23
2020-11-23 08:15:00,2020-11-24 08:15:00,24.0,157,6,2,157,4,1,1,2,12.9 %,2020-11-23
2020-11-23 08:20:00,2020-11-23 13:20:00,5.0,157,6,2,157,2,1,1,4,12.9 %,2020-11-23
2020-11-23 09:00:00,2020-11-24 09:00:00,24.0,157,6,1,157,4,1,0,2,12.9 %,2020-11-23
2020-11-24 07:25:00,2020-11-25 07:25:00,24.0,157,5,2,157,6,2,0,-1,0,2020-11-24
2020-11-24 07:40:00,2020-11-25 07:40:00,24.0,157,5,2,157,6,2,0,-1,0,2020-11-24
2020-11-24 08:00:00,2020-11-24 17:00:00,9.0,157,5,1,157,4,1,0,1,0,2020-11-24
2020-11-24 09:15:00,2020-11-25 09:15:00,24.0,157,5,1,157,6,1,0,-1,0,2020-11-24
2020-11-24 18:50:00,2020-11-25 18:50:00,24.0,157,5,1,157,6,1,0,-1,0,2020-11-24
2020-11-25 07:50:00,2020-11-25 20:50:00,13.0,157,6,1,157,6,1,0,0,0,2020-11-25
2020-11-25 08:10:00,2020-11-26 08:10:00,24.0,157,6,3,157,5,3,0,1,0,2020-11-25
2020-11-25 08:20:00,2020-11-26 08:20:00,24.0,157,6,3,157,5,3,0,1,0,2020-11-25
2020-11-25 08:55:00,2020-11-26 08:55:00,24.0,157,6,3,157,5,3,0,1,0,2020-11-25
2020-11-25 09:00:00,2020-11-26 09:00:00,24.0,157,6,2,157,5,2,0,1,0,2020-11-25
2020-11-25 09:05:00,2020-11-26 09:05:00,24.0,157,6,2,157,5,2,0,1,0,2020-11-25
2020-11-26 08:20:00,2020-11-27 08:20:00,24.0,157,4,2,157,4,2,0,0,0,2020-11-26
2020-11-26 08:30:00,2020-11-27 08:30:00,24.0,157,4,2,157,4,2,0,0,0,2020-11-26
2020-11-26 09:15:00,2020-11-27 09:15:00,24.0,157,4,2,157,4,2,0,0,0,2020-11-26
2020-11-26 09:35:00,2020-11-27 09:35:00,24.0,157,4,2,157,4,2,0,0,0,2020-11-26
2020-11-27 07:20:00,2020-11-28 07:20:00,24.0,157,6,2,157,6,2,0,0,0,2020-11-27
2020-11-27 07:40:00,2020-11-28 07:40:00,24.0,157,6,2,157,6,2,0,0,0,2020-11-27
2020-11-27 08:25:00,2020-11-28 08:25:00,24.0,157,6,2,157,6,2,0,0,0,2020-11-27
2020-11-27 08:30:00,2020-11-28 08:30:00,24.0,157,6,2,157,6,2,0,0,0,2020-11-27
2020-11-27 10:55:00,2020-11-28 10:55:00,24.0,157,6,1,157,6,1,0,0,0,2020-11-27
2020-11-27 19:15:00,2020-11-28 19:15:00,24.0,157,6,1,157,6,1,0,0,0,2020-11-27
2020-11-28 01:00:00,2020-11-30 06:00:00,53.0,157,3,1,157,3,1,0,0,0,2020-11-28
2020-11-28 08:25:00,2020-11-29 08:25:00,24.0,157,3,1,157,2,1,0,1,0,2020-11-28
2020-11-28 09:50:00,2020-11-29 09:50:00,24.0,157,3,1,157,2,1,0,1,0,2020-11-28
2020-11-30 07:05:00,2020-12-01 07:05:00,24.0,157,8,4,172,7,2,2,1,0,2020-11-30
2020-11-30 07:10:00,2020-12-01 07:10:00,24.0,157,8,4,172,7,2,2,1,0,2020-11-30
2020-11-30 07:50:00,2020-11-30 20:50:00,13.0,157,8,4,157,3,1,3,5,0,2020-11-30
2020-11-30 07:55:00,2020-11-30 13:55:00,6.0,157,8,4,157,3,1,3,5,0,2020-11-30
2020-11-30 08:05:00,2020-12-01 08:05:00,24.0,157,8,2,172,7,2,0,1,0,2020-11-30
2020-11-30 08:30:00,2020-12-01 08:30:00,24.0,157,8,2,172,7,2,0,1,0,2020-11-30
2020-11-30 09:00:00,2020-12-01 09:00:00,24.0,157,8,1,172,7,1,0,1,0,2020-11-30
2020-11-30 17:05:00,2020-12-01 17:05:00,24.0,157,8,1,172,7,1,0,1,0,2020-11-30
2020-12-01 07:30:00,2020-12-01 20:30:00,13.0,169,8,1,172,7,1,0,1,0,2020-12-01
2020-12-01 08:00:00,2020-12-02 08:00:00,24.0,169,8,4,172,8,4,0,0,0,2020-12-01
2020-12-01 08:05:00,2020-12-02 08:05:00,24.0,169,8,4,172,8,4,0,0,0,2020-12-01
2020-12-01 08:30:00,2020-12-02 08:30:00,24.0,169,8,4,172,8,4,0,0,0,2020-12-01
2020-12-01 08:45:00,2020-12-02 08:45:00,24.0,169,8,4,172,8,4,0,0,0,2020-12-01
2020-12-01 09:15:00,2020-12-02 09:15:00,24.0,169,8,2,172,8,2,0,0,0,2020-12-01
2020-12-01 09:25:00,2020-12-02 09:25:00,24.0,169,8,2,172,8,2,0,0,0,2020-12-01
2020-12-01 17:05:00,2020-12-02 17:05:00,24.0,169,8,1,172,8,1,0,0,0,2020-12-01
2020-12-02 07:50:00,2020-12-03 07:50:00,24.0,169,6,2,172,6,1,1,0,0,2020-12-02
2020-12-02 07:50:00,2020-12-02 19:50:00,12.0,169,6,2,172,8,1,1,-2,0,2020-12-02
2020-12-02 08:25:00,2020-12-03 08:25:00,24.0,169,6,2,172,6,2,0,0,0,2020-12-02
2020-12-02 08:30:00,2020-12-03 08:30:00,24.0,169,6,2,172,6,2,0,0,0,2020-12-02
2020-12-02 09:30:00,2020-12-03 09:30:00,24.0,169,6,1,172,6,1,0,0,0,2020-12-02
2020-12-02 17:05:00,2020-12-03 17:05:00,24.0,169,6,1,172,6,1,0,0,0,2020-12-02
2020-12-03 08:25:00,2020-12-03 21:25:00,13.0,169,6,3,172,6,1,2,0,0,2020-12-03
2020-12-03 08:35:00,2020-12-04 08:35:00,24.0,169,6,3,172,6,2,1,0,0,2020-12-03
2020-12-03 08:50:00,2020-12-04 08:50:00,24.0,169,6,3,172,6,2,1,0,0,2020-12-03
2020-12-03 11:20:00,2020-12-04 11:20:00,24.0,169,6,2,172,6,2,0,0,0,2020-12-03
2020-12-03 11:20:00,2020-12-04 11:20:00,24.0,169,6,2,172,6,2,0,0,0,2020-12-03
2020-12-03 17:05:00,2020-12-04 17:05:00,24.0,169,6,1,172,6,1,0,0,0,2020-12-03
2020-12-04 07:50:00,2020-12-04 18:50:00,11.0,169,5,1,172,6,1,0,-1,4,2020-12-04
2020-12-04 08:25:00,2020-12-05 08:25:00,24.0,169,5,4,172,5,4,0,0,4,2020-12-04
2020-12-04 08:50:00,2020-12-05 08:50:00,24.0,169,5,4,172,5,4,0,0,4,2020-12-04
2020-12-04 08:55:00,2020-12-05 08:55:00,24.0,169,5,4,172,5,4,0,0,4,2020-12-04
2020-12-04 08:55:00,2020-12-05 08:55:00,24.0,169,5,4,172,5,4,0,0,4,2020-12-04
2020-12-05 09:00:00,2020-12-06 09:00:00,24.0,169,2,1,172,1,1,0,1,0,2020-12-05
2020-12-05 19:25:00,2020-12-05 20:25:00,1.0,169,2,1,172,5,1,0,-3,0,2020-12-05
2020-12-07 07:05:00,2020-12-08 07:05:00,24.0,169,7,3,172,8,3,0,-1,0,2020-12-07
2020-12-07 07:45:00,2020-12-08 07:45:00,24.0,169,7,3,172,8,3,0,-1,0,2020-12-07
2020-12-07 07:55:00,2020-12-08 07:55:00,24.0,169,7,3,172,8,3,0,-1,0,2020-12-07
2020-12-07 08:00:00,2020-12-08 08:00:00,24.0,169,7,2,172,8,1,1,-1,0,2020-12-07
2020-12-07 08:10:00,2020-12-07 14:10:00,6.0,169,7,2,172,1,1,1,6,0,2020-12-07
2020-12-07 09:00:00,2020-12-08 09:00:00,24.0,169,7,1,172,8,1,0,-1,0,2020-12-07
2020-12-07 10:05:00,2020-12-08 10:05:00,24.0,169,7,1,172,8,1,0,-1,0,2020-12-07
2020-12-08 07:20:00,2020-12-09 07:20:00,24.0,169,8,1,172,6,1,0,2,0,2020-12-08
2020-12-08 08:25:00,2020-12-09 08:25:00,24.0,169,8,1,172,6,1,0,2,0,2020-12-08
2020-12-08 09:15:00,2020-12-09 09:15:00,24.0,169,8,2,172,6,2,0,2,0,2020-12-08
2020-12-08 09:15:00,2020-12-09 09:15:00,24.0,169,8,2,172,6,2,0,2,0,2020-12-08
2020-12-08 10:00:00,2020-12-08 17:00:00,7.0,169,8,1,172,8,2,-1,0,0,2020-12-08
2020-12-08 13:15:00,2020-12-09 13:15:00,24.0,169,8,1,172,6,1,0,2,0,2020-12-08
2020-12-08 14:15:00,2020-12-08 17:15:00,3.0,169,8,1,172,8,2,-1,0,0,2020-12-08
2020-12-08 22:50:00,2020-12-09 22:50:00,24.0,169,8,1,172,6,1,0,2,0,2020-12-08
2020-12-09 08:20:00,2020-12-10 08:20:00,24.0,169,5,4,172,5,4,0,0,0,2020-12-09
2020-12-09 08:30:00,2020-12-10 08:30:00,24.0,169,5,4,172,5,4,0,0,0,2020-12-09
2020-12-09 08:30:00,2020-12-10 08:30:00,24.0,169,5,4,172,5,4,0,0,0,2020-12-09
2020-12-09 08:55:00,2020-12-10 08:55:00,24.0,169,5,4,172,5,4,0,0,0,2020-12-09
2020-12-09 23:10:00,2020-12-10 23:10:00,24.0,169,5,1,172,5,1,0,0,0,2020-12-09
2020-12-10 08:25:00,2020-12-11 08:25:00,24.0,169,10,4,172,9,4,0,1,0,2020-12-10
2020-12-10 08:30:00,2020-12-11 08:30:00,24.0,169,10,4,172,9,4,0,1,0,2020-12-10
2020-12-10 08:35:00,2020-12-11 08:35:00,24.0,169,10,4,172,9,4,0,1,0,2020-12-10
2020-12-10 08:35:00,2020-12-11 08:35:00,24.0,169,10,4,172,9,4,0,1,0,2020-12-10
2020-12-10 09:00:00,2020-12-11 09:00:00,24.0,169,10,4,172,9,4,0,1,0,2020-12-10
2020-12-10 09:20:00,2020-12-11 09:20:00,24.0,169,10,4,172,9,4,0,1,0,2020-12-10
2020-12-10 09:25:00,2020-12-11 09:25:00,24.0,169,10,4,172,9,4,0,1,0,2020-12-10
2020-12-10 09:35:00,2020-12-11 09:35:00,24.0,169,10,4,172,9,4,0,1,0,2020-12-10
2020-12-10 13:50:00,2020-12-11 13:50:00,24.0,169,10,1,172,9,1,0,1,0,2020-12-10
2020-12-10 21:35:00,2020-12-14 21:35:00,96.0,169,10,1,172,4,1,0,6,0,2020-12-10
2020-12-11 07:50:00,2020-12-12 07:50:00,24.0,169,10,1,172,9,1,0,1,<1 %,2020-12-11
2020-12-11 08:00:00,2020-12-12 08:00:00,24.0,169,10,5,172,9,5,0,1,<1 %,2020-12-11
2020-12-11 08:10:00,2020-12-12 08:10:00,24.0,169,10,5,172,9,5,0,1,<1 %,2020-12-11
2020-12-11 08:25:00,2020-12-12 08:25:00,24.0,169,10,5,172,9,5,0,1,<1 %,2020-12-11
2020-12-11 08:45:00,2020-12-12 08:45:00,24.0,169,10,5,172,9,5,0,1,<1 %,2020-12-11
2020-12-11 08:55:00,2020-12-12 08:55:00,24.0,169,10,5,172,9,5,0,1,<1 %,2020-12-11
2020-12-11 09:20:00,2020-12-12 09:20:00,24.0,169,10,1,172,9,1,0,1,<1 %,2020-12-11
2020-12-11 10:00:00,2020-12-12 10:00:00,24.0,169,10,1,172,9,1,0,1,<1 %,2020-12-11
2020-12-11 17:40:00,2020-12-13 16:40:00,47.0,169,10,1,172,4,1,0,6,<1 %,2020-12-11
2020-12-11 20:55:00,2020-12-12 20:55:00,24.0,169,10,1,172,9,1,0,1,<1 %,2020-12-11
2020-12-12 01:00:00,2020-12-19 06:00:00,173.0,169,4,1,172,11,1,0,-7,0,2020-12-12
2020-12-12 08:10:00,2020-12-13 08:10:00,24.0,169,4,1,172,4,1,0,0,0,2020-12-12
2020-12-12 09:35:00,2020-12-13 09:35:00,24.0,169,4,1,172,4,1,0,0,0,2020-12-12
2020-12-12 23:10:00,2020-12-13 23:10:00,24.0,169,4,1,172,4,1,0,0,0,2020-12-12
2020-12-13 13:25:00,2020-12-14 13:25:00,24.0,169,1,1,172,4,1,0,-3,5,2020-12-13
2020-12-14 07:05:00,2020-12-15 07:05:00,24.0,169,9,3,172,10,2,1,-1,0,2020-12-14
2020-12-14 07:05:00,2020-12-15 07:05:00,24.0,169,9,3,172,10,2,1,-1,0,2020-12-14
2020-12-14 07:45:00,2020-12-14 20:45:00,13.0,169,9,3,172,4,1,2,5,0,2020-12-14
2020-12-14 08:00:00,2020-12-15 08:00:00,24.0,169,9,3,172,10,2,1,-1,0,2020-12-14
2020-12-14 08:05:00,2020-12-14 19:05:00,11.0,169,9,3,172,4,1,2,5,0,2020-12-14
2020-12-14 08:15:00,2020-12-15 08:15:00,24.0,169,9,3,172,10,2,1,-1,0,2020-12-14
2020-12-14 09:00:00,2020-12-15 09:00:00,24.0,169,9,2,172,10,1,1,-1,0,2020-12-14
2020-12-14 09:45:00,2020-12-19 21:45:00,132.0,169,9,2,172,11,1,1,-2,0,2020-12-14
2020-12-14 15:20:00,2020-12-15 15:20:00,24.0,169,9,1,172,10,1,0,-1,0,2020-12-14
2020-12-15 07:30:00,2020-12-16 07:30:00,24.0,169,10,1,172,8,1,0,2,0,2020-12-15
2020-12-15 08:20:00,2020-12-16 08:20:00,24.0,169,10,4,172,8,4,0,2,0,2020-12-15
2020-12-15 08:25:00,2020-12-16 08:25:00,24.0,169,10,4,172,8,4,0,2,0,2020-12-15
2020-12-15 08:50:00,2020-12-16 08:50:00,24.0,169,10,4,172,8,4,0,2,0,2020-12-15
2020-12-15 08:55:00,2020-12-16 08:55:00,24.0,169,10,4,172,8,4,0,2,0,2020-12-15
2020-12-15 09:05:00,2020-12-15 12:05:00,3.0,169,10,2,172,10,1,1,0,0,2020-12-15
2020-12-15 09:10:00,2020-12-16 09:10:00,24.0,169,10,2,172,8,1,1,2,0,2020-12-15
2020-12-15 12:05:00,2020-12-15 17:05:00,5.0,169,10,1,172,10,3,-2,0,0,2020-12-15
2020-12-15 14:00:00,2020-12-15 17:00:00,3.0,169,10,2,172,10,3,-1,0,0,2020-12-15
2020-12-15 14:15:00,2020-12-15 17:15:00,3.0,169,10,2,172,10,3,-1,0,0,2020-12-15
2020-12-16 07:30:00,2020-12-17 07:30:00,24.0,169,8,2,172,7,1,1,1,0,2020-12-16
2020-12-16 07:50:00,2020-12-16 20:50:00,13.0,169,8,2,172,8,1,1,0,0,2020-12-16
2020-12-16 08:10:00,2020-12-17 08:10:00,24.0,169,8,2,172,7,2,0,1,0,2020-12-16
2020-12-16 08:30:00,2020-12-17 08:30:00,24.0,169,8,2,172,7,2,0,1,0,2020-12-16
2020-12-16 09:05:00,2020-12-17 09:05:00,24.0,169,8,2,172,7,2,0,1,0,2020-12-16
2020-12-16 09:15:00,2020-12-17 09:15:00,24.0,169,8,2,172,7,2,0,1,0,2020-12-16
2020-12-16 12:05:00,2020-12-17 12:05:00,24.0,169,8,1,172,7,1,0,1,0,2020-12-16
2020-12-16 15:35:00,2020-12-16 17:35:00,2.0,169,8,1,172,8,1,0,0,0,2020-12-16
2020-12-17 07:35:00,2020-12-18 07:35:00,24.0,169,13,2,172,12,2,0,1,0,2020-12-17
2020-12-17 07:35:00,2020-12-18 07:35:00,24.0,169,13,2,172,12,2,0,1,0,2020-12-17
2020-12-17 08:25:00,2020-12-18 08:25:00,24.0,169,13,5,172,12,5,0,1,0,2020-12-17
2020-12-17 08:30:00,2020-12-18 08:30:00,24.0,169,13,5,172,12,5,0,1,0,2020-12-17
2020-12-17 08:30:00,2020-12-18 08:30:00,24.0,169,13,5,172,12,5,0,1,0,2020-12-17
2020-12-17 08:35:00,2020-12-18 08:35:00,24.0,169,13,5,172,12,5,0,1,0,2020-12-17
2020-12-17 08:55:00,2020-12-18 08:55:00,24.0,169,13,5,172,12,5,0,1,0,2020-12-17
2020-12-17 09:00:00,2020-12-18 09:00:00,24.0,169,13,4,172,12,3,1,1,0,2020-12-17
2020-12-17 09:15:00,2020-12-18 09:15:00,24.0,169,13,4,172,12,3,1,1,0,2020-12-17
2020-12-17 09:40:00,2020-12-17 17:40:00,8.0,169,13,4,172,7,1,3,6,0,2020-12-17
2020-12-17 09:40:00,2020-12-18 09:40:00,24.0,169,13,4,172,12,3,1,1,0,2020-12-17
2020-12-17 11:35:00,2020-12-18 11:35:00,24.0,169,13,1,172,12,1,0,1,0,2020-12-17
2020-12-17 13:50:00,2020-12-18 13:50:00,24.0,169,13,1,172,12,1,0,1,0,2020-12-17
2020-12-18 07:35:00,2020-12-19 07:35:00,24.0,169,8,3,172,11,3,0,-3,0,2020-12-18
2020-12-18 07:50:00,2020-12-19 07:50:00,24.0,169,8,3,172,11,3,0,-3,0,2020-12-18
2020-12-18 07:50:00,2020-12-19 07:50:00,24.0,169,8,3,172,11,3,0,-3,0,2020-12-18
2020-12-18 08:35:00,2020-12-19 08:35:00,24.0,169,8,2,172,11,2,0,-3,0,2020-12-18
2020-12-18 08:40:00,2020-12-19 08:40:00,24.0,169,8,2,172,11,2,0,-3,0,2020-12-18
2020-12-18 09:00:00,2020-12-19 09:00:00,24.0,169,8,2,172,11,2,0,-3,0,2020-12-18
2020-12-18 09:10:00,2020-12-19 09:10:00,24.0,169,8,2,172,11,2,0,-3,0,2020-12-18
2020-12-18 17:55:00,2020-12-19 17:55:00,24.0,169,8,1,172,11,1,0,-3,0,2020-12-18
2020-12-19 08:20:00,2020-12-20 08:20:00,24.0,169,1,1,172,1,1,0,0,0,2020-12-19
2020-12-21 07:30:00,2020-12-22 07:30:00,24.0,169,6,1,172,9,1,0,-3,0,2020-12-21
2020-12-21 08:10:00,2020-12-21 14:10:00,6.0,169,6,4,172,1,1,3,5,0,2020-12-21
2020-12-21 08:50:00,2020-12-22 08:50:00,24.0,169,6,4,172,9,3,1,-3,0,2020-12-21
2020-12-21 08:50:00,2020-12-22 08:50:00,24.0,169,6,4,172,9,3,1,-3,0,2020-12-21
2020-12-21 08:55:00,2020-12-22 08:55:00,24.0,169,6,4,172,9,3,1,-3,0,2020-12-21
2020-12-21 09:00:00,2020-12-22 09:00:00,24.0,169,6,1,172,9,1,0,-3,0,2020-12-21
2020-12-22 07:20:00,2020-12-23 07:20:00,24.0,169,12,2,172,9,2,0,3,0,2020-12-22
2020-12-22 07:55:00,2020-12-23 07:55:00,24.0,169,12,2,172,9,2,0,3,0,2020-12-22
2020-12-22 08:20:00,2020-12-22 18:20:00,10.0,169,12,6,172,9,1,5,3,0,2020-12-22
2020-12-22 08:25:00,2020-12-23 08:25:00,24.0,169,12,6,172,9,4,2,3,0,2020-12-22
2020-12-22 08:30:00,2020-12-22 19:30:00,11.0,169,12,6,172,9,1,5,3,0,2020-12-22
2020-12-22 08:30:00,2020-12-23 08:30:00,24.0,169,12,6,172,9,4,2,3,0,2020-12-22
2020-12-22 08:50:00,2020-12-23 08:50:00,24.0,169,12,6,172,9,4,2,3,0,2020-12-22
2020-12-22 08:55:00,2020-12-23 08:55:00,24.0,169,12,6,172,9,4,2,3,0,2020-12-22
2020-12-22 09:00:00,2020-12-23 09:00:00,24.0,169,12,2,172,9,2,0,3,0,2020-12-22
2020-12-22 09:00:00,2020-12-23 09:00:00,24.0,169,12,2,172,9,2,0,3,0,2020-12-22
2020-12-22 15:15:00,2020-12-22 17:15:00,2.0,169,12,2,172,9,1,1,3,0,2020-12-22
2020-12-22 15:20:00,2020-12-22 16:20:00,1.0,169,12,2,172,9,1,1,3,0,2020-12-22
2020-12-23 07:50:00,2020-12-24 07:50:00,24.0,169,9,2,172,8,2,0,1,0,2020-12-23
2020-12-23 07:55:00,2020-12-24 07:55:00,24.0,169,9,2,172,8,2,0,1,0,2020-12-23
2020-12-23 08:05:00,2020-12-24 08:05:00,24.0,169,9,2,172,8,2,0,1,0,2020-12-23
2020-12-23 08:50:00,2020-12-24 08:50:00,24.0,169,9,2,172,8,2,0,1,0,2020-12-23
2020-12-23 09:00:00,2020-12-24 09:00:00,24.0,169,9,2,172,8,2,0,1,0,2020-12-23
2020-12-23 09:00:00,2020-12-24 09:00:00,24.0,169,9,2,172,8,2,0,1,0,2020-12-23
2020-12-23 15:05:00,2020-12-24 15:05:00,24.0,169,9,1,172,8,1,0,1,0,2020-12-23
2020-12-23 16:15:00,2020-12-23 17:15:00,1.0,169,9,1,172,9,1,0,0,0,2020-12-23
2020-12-23 22:10:00,2020-12-24 22:10:00,24.0,169,9,1,172,8,1,0,1,0,2020-12-23
2020-12-27 20:50:00,2020-12-30 20:50:00,72.0,169,1,1,172,5,2,-1,-4,0,2020-12-27
2020-12-28 07:55:00,2020-12-28 20:55:00,13.0,169,6,1,172,4,1,0,2,0,2020-12-28
2020-12-28 08:15:00,2020-12-28 18:15:00,10.0,169,6,2,172,4,2,0,2,0,2020-12-28
2020-12-28 08:15:00,2020-12-28 18:15:00,10.0,169,6,2,172,4,2,0,2,0,2020-12-28
2020-12-28 09:30:00,2020-12-29 09:30:00,24.0,169,6,1,172,4,1,0,2,0,2020-12-28
2020-12-28 11:10:00,2020-12-29 11:10:00,24.0,169,6,2,172,4,1,1,2,0,2020-12-28
2020-12-28 11:20:00,2020-12-28 12:20:00,1.0,169,6,2,172,4,1,1,2,0,2020-12-28
2020-12-29 08:15:00,2020-12-29 18:15:00,10.0,169,4,3,172,4,1,2,0,0,2020-12-29
2020-12-29 08:40:00,2020-12-30 08:40:00,24.0,169,4,3,172,5,2,1,-1,0,2020-12-29
2020-12-29 08:55:00,2020-12-30 08:55:00,24.0,169,4,3,172,5,2,1,-1,0,2020-12-29
2020-12-29 15:40:00,2020-12-29 16:40:00,1.0,169,4,1,172,4,1,0,0,0,2020-12-29
2020-12-30 07:45:00,2020-12-30 20:45:00,13.0,169,6,1,172,5,2,-1,1,0,2020-12-30
2020-12-30 08:15:00,2020-12-30 18:15:00,10.0,169,6,3,172,5,1,2,1,0,2020-12-30
2020-12-30 08:25:00,2020-12-31 08:25:00,24.0,169,6,3,172,4,2,1,2,0,2020-12-30
2020-12-30 08:45:00,2020-12-31 08:45:00,24.0,169,6,3,172,4,2,1,2,0,2020-12-30
2020-12-30 09:10:00,2020-12-31 09:10:00,24.0,169,6,2,172,4,2,0,2,0,2020-12-30
2020-12-30 09:55:00,2020-12-31 09:55:00,24.0,169,6,2,172,4,2,0,2,0,2020-12-30
2020-12-31 08:45:00,2021-01-01 08:45:00,24.0,169,4,2,255,3,2,0,1,5,2020-12-31
2020-12-31 08:45:00,2021-01-01 08:45:00,24.0,169,4,2,255,3,2,0,1,5,2020-12-31
2020-12-31 14:40:00,2021-01-01 14:40:00,24.0,169,4,1,255,3,1,0,1,5,2020-12-31
2020-12-31 17:10:00,2021-01-02 17:10:00,48.0,169,4,1,255,3,1,0,1,5,2020-12-31
2021-01-01 15:00:00,2021-01-02 15:00:00,24.0,260,2,2,255,3,2,0,-1,2,2021-01-01
2021-01-01 15:35:00,2021-01-02 15:35:00,24.0,260,2,2,255,3,2,0,-1,2,2021-01-01
2021-01-02 10:20:00,2021-01-03 10:20:00,24.0,260,3,1,255,3,1,0,0,0,2021-01-02
2021-01-02 15:00:00,2021-01-03 15:00:00,24.0,260,3,1,255,3,1,0,0,0,2021-01-02
2021-01-02 20:10:00,2021-01-03 20:10:00,24.0,260,3,1,255,3,1,0,0,0,2021-01-02
2021-01-03 20:10:00,2021-01-04 20:10:00,24.0,260,2,1,255,4,1,0,-2,0,2021-01-03
2021-01-04 08:15:00,2021-01-04 18:15:00,10.0,260,7,4,255,4,2,2,3,0,2021-01-04
2021-01-04 08:30:00,2021-01-04 18:30:00,10.0,260,7,4,255,4,2,2,3,0,2021-01-04
2021-01-04 08:55:00,2021-01-05 08:55:00,24.0,260,7,4,255,8,2,2,-1,0,2021-01-04
2021-01-04 09:15:00,2021-01-05 09:15:00,24.0,260,7,2,255,8,2,0,-1,0,2021-01-04
2021-01-04 20:10:00,2021-01-05 20:10:00,24.0,260,7,1,255,8,1,0,-1,0,2021-01-04
2021-01-05 07:20:00,2021-01-06 07:20:00,24.0,260,15,3,255,17,3,0,-2,0,2021-01-05
2021-01-05 07:30:00,2021-01-06 07:30:00,24.0,260,15,3,255,17,3,0,-2,0,2021-01-05
2021-01-05 07:40:00,2021-01-06 07:40:00,24.0,260,15,3,255,17,3,0,-2,0,2021-01-05
2021-01-05 08:25:00,2021-01-06 08:25:00,24.0,260,15,1,255,17,2,-1,-2,0,2021-01-05
2021-01-05 09:00:00,2021-01-06 09:00:00,24.0,260,15,5,255,17,4,1,-2,0,2021-01-05
2021-01-05 09:00:00,2021-01-05 19:00:00,10.0,260,15,5,255,8,1,4,7,0,2021-01-05
2021-01-05 09:05:00,2021-01-06 09:05:00,24.0,260,15,5,255,17,4,1,-2,0,2021-01-05
2021-01-05 09:10:00,2021-01-06 09:10:00,24.0,260,15,5,255,17,4,1,-2,0,2021-01-05
2021-01-05 09:25:00,2021-01-06 09:25:00,24.0,260,15,5,255,17,4,1,-2,0,2021-01-05
2021-01-05 10:40:00,2021-01-06 10:40:00,24.0,260,15,1,255,17,1,0,-2,0,2021-01-05
2021-01-05 11:00:00,2021-01-06 11:00:00,24.0,260,15,1,255,17,1,0,-2,0,2021-01-05
2021-01-05 14:45:00,2021-01-05 18:45:00,4.0,260,15,2,255,8,1,1,7,0,2021-01-05
2021-01-05 20:10:00,2021-01-06 20:10:00,24.0,260,15,1,255,17,2,-1,-2,0,2021-01-05
2021-01-06 07:10:00,2021-01-07 07:10:00,24.0,260,20,7,255,13,4,3,7,0,2021-01-06
2021-01-06 07:20:00,2021-01-06 08:20:00,1.0,260,20,7,255,17,2,5,3,0,2021-01-06
2021-01-06 07:25:00,2021-01-07 07:25:00,24.0,260,20,7,255,13,4,3,7,0,2021-01-06
2021-01-06 07:45:00,2021-01-06 20:45:00,13.0,260,20,7,255,17,2,5,3,0,2021-01-06
2021-01-06 08:15:00,2021-01-06 18:15:00,10.0,260,20,7,255,17,1,6,3,0,2021-01-06
2021-01-06 08:40:00,2021-01-07 08:40:00,24.0,260,20,7,255,13,5,2,7,0,2021-01-06
2021-01-06 08:45:00,2021-01-06 19:45:00,11.0,260,20,7,255,17,1,6,3,0,2021-01-06
2021-01-06 23:45:00,2021-01-07 23:45:00,24.0,260,20,1,255,13,1,0,7,0,2021-01-06
2021-01-07 07:20:00,2021-01-08 07:20:00,24.0,260,15,3,255,20,3,0,-5,0,2021-01-07
2021-01-07 08:20:00,2021-01-08 08:20:00,24.0,260,15,7,255,20,8,-1,-5,0,2021-01-07
2021-01-07 08:40:00,2021-01-08 08:40:00,24.0,260,15,7,255,20,8,-1,-5,0,2021-01-07
2021-01-07 08:40:00,2021-01-08 08:40:00,24.0,260,15,7,255,20,8,-1,-5,0,2021-01-07
2021-01-07 08:40:00,2021-01-08 08:40:00,24.0,260,15,7,255,20,8,-1,-5,0,2021-01-07
2021-01-07 09:00:00,2021-01-07 19:00:00,10.0,260,15,4,255,13,1,3,2,0,2021-01-07
2021-01-07 09:15:00,2021-01-08 09:15:00,24.0,260,15,4,255,20,3,1,-5,0,2021-01-07
2021-01-07 09:35:00,2021-01-08 09:35:00,24.0,260,15,4,255,20,3,1,-5,0,2021-01-07
2021-01-07 23:10:00,2021-01-08 23:10:00,24.0,260,15,1,255,20,1,0,-5,0,2021-01-07
2021-01-08 07:20:00,2021-01-08 08:20:00,1.0,260,17,5,255,20,8,-3,-3,1,2021-01-08
2021-01-08 07:25:00,2021-01-09 07:25:00,24.0,260,17,5,255,13,2,3,4,1,2021-01-08
2021-01-08 07:50:00,2021-01-08 19:50:00,12.0,260,17,5,255,20,2,3,-3,1,2021-01-08
2021-01-08 08:55:00,2021-01-09 08:55:00,24.0,260,17,4,255,13,4,0,4,1,2021-01-08
2021-01-08 09:00:00,2021-01-08 19:00:00,10.0,260,17,2,255,20,2,0,-3,1,2021-01-08
2021-01-08 12:40:00,2021-01-08 13:40:00,1.0,260,17,2,255,20,1,1,-3,1,2021-01-08
2021-01-08 19:00:00,2021-01-09 19:00:00,24.0,260,17,1,255,13,1,0,4,1,2021-01-08
2021-01-08 23:20:00,2021-01-09 23:20:00,24.0,260,17,1,255,13,1,0,4,1,2021-01-08
2021-01-09 08:20:00,2021-01-10 08:20:00,24.0,260,10,3,255,10,3,0,0,0,2021-01-09
2021-01-09 14:05:00,2021-01-09 15:05:00,1.0,260,10,1,255,13,1,0,-3,0,2021-01-09
2021-01-09 15:05:00,2021-01-09 16:05:00,1.0,260,10,1,255,13,1,0,-3,0,2021-01-09
2021-01-09 16:20:00,2021-01-10 16:20:00,24.0,260,10,1,255,10,1,0,0,0,2021-01-09
2021-01-09 19:00:00,2021-01-10 19:00:00,24.0,260,10,1,255,10,1,0,0,0,2021-01-09
2021-01-10 09:35:00,2021-01-11 09:35:00,24.0,260,2,2,255,3,1,1,-1,0,2021-01-10
2021-01-11 07:25:00,2021-01-12 07:25:00,24.0,260,8,2,255,11,2,0,-3,5,2021-01-11
2021-01-11 07:50:00,2021-01-12 07:50:00,24.0,260,8,2,255,11,2,0,-3,5,2021-01-11
2021-01-11 08:05:00,2021-01-12 08:05:00,24.0,260,8,4,255,11,3,1,-3,5,2021-01-11
2021-01-11 08:05:00,2021-01-11 14:05:00,6.0,260,8,4,255,3,1,3,5,5,2021-01-11
2021-01-11 08:30:00,2021-01-12 08:30:00,24.0,260,8,4,255,11,3,1,-3,5,2021-01-11
2021-01-11 09:00:00,2021-01-12 09:00:00,24.0,260,8,1,255,11,2,-1,-3,5,2021-01-11
2021-01-11 12:10:00,2021-01-12 12:10:00,24.0,260,8,1,255,11,1,0,-3,5,2021-01-11
2021-01-12 07:30:00,2021-01-13 07:30:00,24.0,260,9,2,255,6,1,1,3,0,2021-01-12
2021-01-12 07:50:00,2021-01-12 13:50:00,6.0,260,9,2,255,11,1,1,-2,0,2021-01-12
2021-01-12 08:05:00,2021-01-12 09:05:00,1.0,260,9,5,255,11,2,3,-2,0,2021-01-12
2021-01-12 08:20:00,2021-01-12 18:20:00,10.0,260,9,5,255,11,2,3,-2,0,2021-01-12
2021-01-12 08:30:00,2021-01-13 08:30:00,24.0,260,9,5,255,6,2,3,3,0,2021-01-12
2021-01-12 08:45:00,2021-01-12 18:45:00,10.0,260,9,5,255,11,2,3,-2,0,2021-01-12
2021-01-12 08:55:00,2021-01-13 08:55:00,24.0,260,9,5,255,6,2,3,3,0,2021-01-12
2021-01-12 09:25:00,2021-01-13 09:25:00,24.0,260,9,1,255,6,1,0,3,0,2021-01-12
2021-01-12 11:10:00,2021-01-13 11:10:00,24.0,260,9,1,255,6,1,0,3,0,2021-01-12
2021-01-13 07:45:00,2021-01-14 07:45:00,24.0,260,12,2,255,10,2,0,2,0,2021-01-13
2021-01-13 07:45:00,2021-01-14 07:45:00,24.0,260,12,2,255,10,2,0,2,0,2021-01-13
2021-01-13 08:05:00,2021-01-14 08:05:00,24.0,260,12,5,255,10,5,0,2,0,2021-01-13
2021-01-13 08:40:00,2021-01-14 08:40:00,24.0,260,12,5,255,10,5,0,2,0,2021-01-13
2021-01-13 09:05:00,2021-01-13 19:05:00,10.0,260,12,2,255,6,1,1,6,0,2021-01-13
2021-01-13 12:35:00,2021-01-14 12:35:00,24.0,260,12,1,255,10,1,0,2,0,2021-01-13
2021-01-13 20:15:00,2021-01-14 20:15:00,24.0,260,12,1,255,10,1,0,2,0,2021-01-13
2021-01-14 07:25:00,2021-01-15 07:25:00,24.0,260,13,1,255,14,1,0,-1,0,2021-01-14
2021-01-14 08:30:00,2021-01-15 08:30:00,24.0,260,13,6,255,14,5,1,-1,0,2021-01-14
2021-01-14 08:30:00,2021-01-15 08:30:00,24.0,260,13,6,255,14,5,1,-1,0,2021-01-14
2021-01-14 08:35:00,2021-01-15 08:35:00,24.0,260,13,6,255,14,5,1,-1,0,2021-01-14
2021-01-14 08:55:00,2021-01-15 08:55:00,24.0,260,13,6,255,14,5,1,-1,0,2021-01-14
2021-01-14 09:00:00,2021-01-15 09:00:00,24.0,260,13,4,255,14,4,0,-1,0,2021-01-14
2021-01-14 09:25:00,2021-01-15 09:25:00,24.0,260,13,4,255,14,4,0,-1,0,2021-01-14
2021-01-14 09:30:00,2021-01-15 09:30:00,24.0,260,13,4,255,14,4,0,-1,0,2021-01-14
2021-01-14 20:30:00,2021-01-15 20:30:00,24.0,260,13,1,255,14,2,-1,-1,0,2021-01-14
2021-01-15 07:45:00,2021-01-15 20:45:00,13.0,260,15,3,255,14,2,1,1,0,2021-01-15
2021-01-15 08:00:00,2021-01-16 08:00:00,24.0,260,15,9,255,11,9,0,4,0,2021-01-15
2021-01-15 08:05:00,2021-01-16 08:05:00,24.0,260,15,9,255,11,9,0,4,0,2021-01-15
2021-01-15 08:25:00,2021-01-16 08:25:00,24.0,260,15,9,255,11,9,0,4,0,2021-01-15
2021-01-15 08:30:00,2021-01-16 08:30:00,24.0,260,15,9,255,11,9,0,4,0,2021-01-15
2021-01-15 08:55:00,2021-01-16 08:55:00,24.0,260,15,9,255,11,9,0,4,0,2021-01-15
2021-01-15 09:00:00,2021-01-15 17:00:00,8.0,260,15,2,255,14,1,1,1,0,2021-01-15
2021-01-15 20:15:00,2021-01-17 20:15:00,48.0,260,15,1,255,7,1,0,8,0,2021-01-15
2021-01-16 08:20:00,2021-01-17 08:20:00,24.0,260,5,3,255,7,4,-1,-2,0,2021-01-16
2021-01-16 21:20:00,2021-01-17 21:20:00,24.0,260,5,1,255,7,1,0,-2,0,2021-01-16
2021-01-18 07:50:00,2021-01-19 07:50:00,24.0,260,1,1,255,1,1,0,0,0,2021-01-18
2021-01-19 07:35:00,2021-01-20 07:35:00,24.0,260,3,1,255,3,1,0,0,0,2021-01-19
2021-01-19 09:00:00,2021-01-20 09:00:00,24.0,260,3,2,255,3,2,0,0,0,2021-01-19
2021-01-19 09:15:00,2021-01-20 09:15:00,24.0,260,3,2,255,3,2,0,0,0,2021-01-19
2021-01-20 08:30:00,2021-01-21 08:30:00,24.0,260,8,5,255,8,5,0,0,0,2021-01-20
2021-01-20 08:45:00,2021-01-21 08:45:00,24.0,260,8,5,255,8,5,0,0,0,2021-01-20
2021-01-20 09:05:00,2021-01-21 09:05:00,24.0,260,8,2,255,8,1,1,0,0,2021-01-20
2021-01-21 07:40:00,2021-01-22 07:40:00,24.0,260,11,1,255,10,1,0,1,0,2021-01-21
2021-01-21 08:30:00,2021-01-22 08:30:00,24.0,260,11,5,255,10,5,0,1,0,2021-01-21
2021-01-21 08:40:00,2021-01-22 08:40:00,24.0,260,11,5,255,10,5,0,1,0,2021-01-21
2021-01-21 08:40:00,2021-01-22 08:40:00,24.0,260,11,5,255,10,5,0,1,0,2021-01-21
2021-01-22 08:35:00,2021-01-23 08:35:00,24.0,260,6,2,255,5,2,0,1,0,2021-01-22
2021-01-25 08:10:00,2021-01-26 08:10:00,24.0,260,2,1,255,3,1,0,-1,0,2021-01-25
2021-01-25 16:10:00,2021-01-26 16:10:00,24.0,260,2,1,255,3,1,0,-1,0,2021-01-25
2021-01-26 09:00:00,2021-01-27 09:00:00,24.0,260,3,2,255,6,2,0,-3,0,2021-01-26
2021-01-26 09:25:00,2021-01-27 09:25:00,24.0,260,3,2,255,6,2,0,-3,0,2021-01-26
2021-01-26 16:00:00,2021-01-27 16:00:00,24.0,260,3,1,255,6,2,-1,-3,0,2021-01-26
2021-01-27 08:00:00,2021-01-28 08:00:00,24.0,260,10,4,255,8,4,0,2,0,2021-01-27
2021-01-27 08:30:00,2021-01-28 08:30:00,24.0,260,10,4,255,8,4,0,2,0,2021-01-27
2021-01-27 14:15:00,2021-01-27 18:15:00,4.0,260,10,1,255,6,1,0,4,0,2021-01-27
2021-01-27 16:15:00,2021-01-28 16:15:00,24.0,260,10,1,255,8,1,0,2,0,2021-01-27
2021-01-27 22:10:00,2021-01-28 22:10:00,24.0,260,10,1,255,8,1,0,2,0,2021-01-27
2021-01-28 07:05:00,2021-01-29 07:05:00,24.0,260,13,3,255,12,3,0,1,0,2021-01-28
2021-01-28 07:40:00,2021-01-29 07:40:00,24.0,260,13,3,255,12,3,0,1,0,2021-01-28
2021-01-28 08:00:00,2021-01-28 23:00:00,15.0,260,13,6,255,8,1,5,5,0,2021-01-28
2021-01-28 08:30:00,2021-01-29 08:30:00,24.0,260,13,6,255,12,5,1,1,0,2021-01-28
2021-01-28 08:40:00,2021-01-29 08:40:00,24.0,260,13,6,255,12,5,1,1,0,2021-01-28
2021-01-28 21:10:00,2021-01-29 21:10:00,24.0,260,13,1,255,12,1,0,1,0,2021-01-28
2021-01-28 22:10:00,2021-01-29 22:10:00,24.0,260,13,1,255,12,1,0,1,0,2021-01-28
2021-01-29 08:35:00,2021-01-30 08:35:00,24.0,260,7,4,255,7,4,0,0,0,2021-01-29
2021-01-29 20:30:00,2021-01-31 20:30:00,48.0,260,7,1,255,17,1,0,-10,0,2021-01-29
2021-01-30 01:00:00,2021-01-31 06:00:00,29.0,260,14,1,255,17,1,0,-3,0,2021-01-30
2021-01-30 11:20:00,2021-01-31 11:20:00,24.0,260,14,1,255,17,1,0,-3,0,2021-01-30
2021-01-30 15:40:00,2021-01-31 15:40:00,24.0,260,14,1,255,17,1,0,-3,0,2021-01-30
2021-01-31 01:00:00,2021-03-01 01:00:00,696.0,260,9,1,129,2,1,0,7,0,2021-01-31
2021-01-31 11:20:00,2021-01-31 12:20:00,1.0,260,9,1,255,17,2,-1,-8,0,2021-01-31
2021-02-01 07:40:00,2021-02-02 07:40:00,24.0,219,9,2,224,7,1,1,2,2,2021-02-01
2021-02-01 08:00:00,2021-02-02 08:00:00,24.0,219,9,3,224,7,2,1,2,2,2021-02-01
2021-02-01 08:00:00,2021-02-01 19:00:00,11.0,219,9,3,224,7,1,2,2,2,2021-02-01
2021-02-01 09:05:00,2021-02-02 09:05:00,24.0,219,9,2,224,7,2,0,2,2,2021-02-01
2021-02-01 09:40:00,2021-02-02 09:40:00,24.0,219,9,2,224,7,2,0,2,2,2021-02-01
2021-02-01 15:30:00,2021-02-02 15:30:00,24.0,219,9,1,224,7,1,0,2,2,2021-02-01
2021-02-02 07:35:00,2021-02-03 07:35:00,24.0,219,4,1,224,4,1,0,0,0,2021-02-02
2021-02-02 09:20:00,2021-02-03 12:20:00,27.0,219,4,3,224,4,1,2,0,0,2021-02-02
2021-02-02 09:20:00,2021-02-03 09:20:00,24.0,219,4,3,224,4,2,1,0,0,2021-02-02
2021-02-02 09:55:00,2021-02-03 09:55:00,24.0,219,4,3,224,4,2,1,0,0,2021-02-02
2021-02-03 07:25:00,2021-02-04 07:25:00,24.0,219,9,2,224,8,2,0,1,0,2021-02-03
2021-02-03 07:35:00,2021-02-04 07:35:00,24.0,219,9,2,224,8,2,0,1,0,2021-02-03
2021-02-03 08:35:00,2021-02-04 08:35:00,24.0,219,9,4,224,8,3,1,1,0,2021-02-03
2021-02-03 09:05:00,2021-02-04 09:05:00,24.0,219,9,3,224,8,3,0,1,0,2021-02-03
2021-02-03 09:30:00,2021-02-04 09:30:00,24.0,219,9,3,224,8,3,0,1,0,2021-02-03
2021-02-03 09:45:00,2021-02-04 09:45:00,24.0,219,9,3,224,8,3,0,1,0,2021-02-03
2021-02-04 06:40:00,2021-02-05 06:40:00,24.0,219,12,1,224,12,1,0,0,2,2021-02-04
2021-02-04 08:25:00,2021-02-05 08:25:00,24.0,219,12,4,224,12,3,1,0,2,2021-02-04
2021-02-04 08:35:00,2021-02-05 08:35:00,24.0,219,12,4,224,12,3,1,0,2,2021-02-04
2021-02-04 12:50:00,2021-02-05 12:50:00,24.0,219,12,2,224,12,2,0,0,2,2021-02-04
2021-02-05 08:10:00,2021-02-06 08:10:00,24.0,219,12,4,224,10,4,0,2,0,2021-02-05
2021-02-05 08:45:00,2021-02-06 08:45:00,24.0,219,12,4,224,10,4,0,2,0,2021-02-05
2021-02-05 20:30:00,2021-02-08 16:30:00,68.0,219,12,1,224,9,1,0,3,0,2021-02-05
2021-02-05 22:40:00,2021-02-07 21:40:00,47.0,219,12,1,224,11,1,0,1,0,2021-02-05
2021-02-08 07:05:00,2021-02-09 07:05:00,24.0,219,7,2,224,6,2,0,1,0,2021-02-08
2021-02-08 07:30:00,2021-02-09 07:30:00,24.0,219,7,2,224,6,2,0,1,0,2021-02-08
2021-02-08 08:10:00,2021-02-08 23:10:00,15.0,219,7,3,224,9,1,2,-2,0,2021-02-08
2021-02-08 08:35:00,2021-02-09 08:35:00,24.0,219,7,3,224,6,2,1,1,0,2021-02-08
2021-02-08 09:40:00,2021-02-08 15:40:00,6.0,219,7,1,224,9,1,0,-2,0,2021-02-08
2021-02-08 12:30:00,2021-02-09 12:30:00,24.0,219,7,1,224,6,1,0,1,0,2021-02-08
2021-02-09 09:25:00,2021-02-10 09:25:00,24.0,219,3,1,224,3,1,0,0,0,2021-02-09
2021-02-09 12:30:00,2021-02-09 19:30:00,7.0,219,3,1,224,6,1,0,-3,0,2021-02-09
2021-02-10 08:35:00,2021-02-11 08:35:00,24.0,219,14,6,224,12,5,1,2,0,2021-02-10
2021-02-10 08:40:00,2021-02-11 08:40:00,24.0,219,14,6,224,12,5,1,2,0,2021-02-10
2021-02-10 08:55:00,2021-02-11 08:55:00,24.0,219,14,6,224,12,5,1,2,0,2021-02-10
2021-02-10 09:10:00,2021-02-11 09:10:00,24.0,219,14,2,224,12,2,0,2,0,2021-02-10
2021-02-10 19:35:00,2021-02-15 09:35:00,110.0,219,14,1,224,5,1,0,9,0,2021-02-10
2021-02-11 07:05:00,2021-02-12 07:05:00,24.0,219,11,2,224,10,2,0,1,5,2021-02-11
2021-02-11 15:25:00,2021-02-12 15:25:00,24.0,219,11,2,224,10,2,0,1,5,2021-02-11
2021-02-11 23:00:00,2021-02-18 23:00:00,168.0,219,11,1,224,11,1,0,0,5,2021-02-11
2021-02-12 07:15:00,2021-02-13 07:15:00,24.0,219,12,3,224,12,3,0,0,0,2021-02-12
2021-02-12 08:20:00,2021-02-13 08:20:00,24.0,219,12,6,224,12,5,1,0,0,2021-02-12
2021-02-12 08:25:00,2021-02-12 19:25:00,11.0,219,12,6,224,10,1,5,2,0,2021-02-12
2021-02-12 08:30:00,2021-02-13 08:30:00,24.0,219,12,6,224,12,5,1,0,0,2021-02-12
2021-02-12 09:00:00,2021-02-13 09:00:00,24.0,219,12,2,224,12,2,0,0,0,2021-02-12
2021-02-12 16:45:00,2021-02-13 16:45:00,24.0,219,12,1,224,12,1,0,0,0,2021-02-12
2021-02-13 16:25:00,2021-02-14 16:25:00,24.0,219,6,1,224,8,1,0,-2,0,2021-02-13
2021-02-13 21:05:00,2021-02-14 03:05:00,6.0,219,6,1,224,8,1,0,-2,0,2021-02-13
2021-02-15 07:45:00,2021-02-15 18:45:00,11.0,219,8,2,224,5,2,0,3,0,2021-02-15
2021-02-15 07:50:00,2021-02-16 07:50:00,24.0,219,8,2,224,6,1,1,2,0,2021-02-15
2021-02-15 08:00:00,2021-02-16 08:00:00,24.0,219,8,3,224,6,2,1,2,0,2021-02-15
2021-02-15 08:30:00,2021-02-15 18:30:00,10.0,219,8,3,224,5,2,1,3,0,2021-02-15
2021-02-15 09:10:00,2021-02-16 09:10:00,24.0,219,8,1,224,6,1,0,2,0,2021-02-15
2021-02-15 15:30:00,2021-02-16 15:30:00,24.0,219,8,1,224,6,1,0,2,0,2021-02-15
2021-02-15 16:40:00,2021-02-16 16:40:00,24.0,219,8,1,224,6,1,0,2,0,2021-02-15
2021-02-16 09:10:00,2021-02-17 09:10:00,24.0,219,2,1,224,3,1,0,-1,0,2021-02-16
2021-02-16 16:40:00,2021-02-17 16:40:00,24.0,219,2,1,224,3,1,0,-1,0,2021-02-16
2021-02-17 07:45:00,2021-02-18 07:45:00,24.0,219,10,4,224,11,3,1,-1,0,2021-02-17
2021-02-17 08:35:00,2021-02-18 08:35:00,24.0,219,10,1,224,11,1,0,-1,0,2021-02-17
2021-02-17 09:05:00,2021-02-18 09:05:00,24.0,219,10,2,224,11,2,0,-1,0,2021-02-17
2021-02-17 12:25:00,2021-02-17 13:25:00,1.0,219,10,1,224,3,1,0,7,0,2021-02-17
2021-02-17 16:40:00,2021-02-18 16:40:00,24.0,219,10,1,224,11,1,0,-1,0,2021-02-17
2021-02-18 07:55:00,2021-02-19 07:55:00,24.0,219,11,1,224,10,1,0,1,0,2021-02-18
2021-02-18 08:00:00,2021-02-19 08:00:00,24.0,219,11,5,224,10,4,1,1,0,2021-02-18
2021-02-18 08:20:00,2021-02-18 22:20:00,14.0,219,11,5,224,11,1,4,0,0,2021-02-18
2021-02-18 10:00:00,2021-02-19 10:00:00,24.0,219,11,1,224,10,1,0,1,0,2021-02-18
2021-02-18 11:40:00,2021-02-18 14:40:00,3.0,219,11,1,224,11,1,0,0,0,2021-02-18
2021-02-18 16:40:00,2021-02-19 16:40:00,24.0,219,11,1,224,10,1,0,1,0,2021-02-18
2021-02-18 23:00:00,2021-02-21 23:00:00,72.0,219,11,1,224,9,1,0,2,0,2021-02-18
2021-02-19 08:20:00,2021-02-20 08:20:00,24.0,219,12,5,224,10,5,0,2,0,2021-02-19
2021-02-19 08:30:00,2021-02-20 08:30:00,24.0,219,12,5,224,10,5,0,2,0,2021-02-19
2021-02-19 08:40:00,2021-02-20 08:40:00,24.0,219,12,5,224,10,5,0,2,0,2021-02-19
2021-02-19 09:05:00,2021-02-20 09:05:00,24.0,219,12,3,224,10,3,0,2,0,2021-02-19
2021-02-19 09:25:00,2021-02-20 09:25:00,24.0,219,12,3,224,10,3,0,2,0,2021-02-19
2021-02-19 16:40:00,2021-02-19 17:40:00,1.0,219,12,1,224,10,1,0,2,0,2021-02-19
2021-02-21 14:25:00,2021-02-27 14:25:00,144.0,219,6,1,224,7,1,0,-1,0,2021-02-21
2021-02-21 20:05:00,2021-02-22 20:05:00,24.0,219,6,1,224,6,1,0,0,0,2021-02-21
2021-02-22 07:55:00,2021-02-23 07:55:00,24.0,219,6,1,224,5,1,0,1,0,2021-02-22
2021-02-22 08:10:00,2021-02-23 08:10:00,24.0,219,6,3,224,5,3,0,1,0,2021-02-22
2021-02-22 09:05:00,2021-02-23 09:05:00,24.0,219,6,1,224,5,1,0,1,0,2021-02-22
